birthplace appears as	name in Kima	appears as birthplace x time
גרוכוב	גרוכוב (ורשה, פולין)	1
חורה	חורה (ישראל)	1
סעקעלהיד	סקוני (רומניה)	1
Aachen (Germany)	אאכן (גרמניה)	3
Aarau (Switzerland)	אראו (שווייץ)	2
Abaújszántó (Hungary)	אבאויסנטו (הונגריה)	1
Abbeville (France)	אבויל (צרפת)	1
Aberdeenshire (Scotland)	אברדינשייר (סקוטלנד)	1
Abingdon (England)	אבינגדון (אנגליה)	1
Acqui Terme (Italy)	אקווי תרמה (איטליה)	1
Acre (Israel)	עכו (ישראל)	10
Adana (Turkey)	אדנה (טורקיה)	1
Adelaide (S. Aust.)	אדלייד (אוסטרליה הדרומית)	1
Aden (Yemen)	עדן (תימן)	9
Adjud (Romania)	אדג'וד (רומניה)	1
Afek (Israel)	אפק (ישראל)	3
Afghanistan	אפגניסטן	3
Afikim (Israel)	אפיקים (ישראל)	7
Afikpo (Nigeria)	אפיקפו (ניגריה)	1
Afula (Israel)	עפולה (ישראל)	17
Agrigento (Italy)	אגריגנטו (איטליה)	1
Ahrensburg (Germany)	ארנסבורג (גרמניה)	1
Aigina (Greece)	אגינה (יוון)	1
Aisne (France)	איין (צרפת)	1
Aix-en-Provence (France)	אקס-אן-פרובנס (צרפת)	3
Ajaccio (France)	אג'אסיו (צרפת)	1
Akmenė (Lithuania)	אקינה (ליטא)	1
Akron (Ohio)	אקרון (אוהיו)	1
Al-Damun (Israel)	אלדאמון (ישראל)	1
Alabama	אלבמה	1
Alba Iulia (Romania)	אלבה יוליה (רומניה)	2
Albania	אלבניה	1
Albany (N.Y.)	אלבני (ניו יורק)	5
Albertirsa (Hungary)	אלברטירשה (הונגריה)	2
Albi (France)	אלבי (צרפת)	1
Alcalá de Henares (Spain)	אלקלה דה אנארס (ספרד)	1
Aldershot (England)	אלדרשוט (אנגליה)	3
Aleksandrów Łodzki (Poland)	אלכסנדר (פולין)	4
Aleksotas (Kaunas, Lithuania)	אלקסוטס (קובנה, ליטא)	1
Alentejo (Portugal)	אלנטז'ו (פורטוגל)	1
Aleppo (Syria)	חלב (סוריה)	90
Alessandria (Italy)	אלסנדריה (איטליה)	1
Alexandria (Egypt)	אלכסנדריה (מצרים)	16
Alexandria (Va.)	אלכסנדריה (וירג'יניה)	1
Algeria	אלג'יריה	13
Algiers (Algeria)	אלג'יר (אלג'יריה)	7
Allahabad (India)	אללהבאד (הודו)	1
Allegany County (N.Y.)	מחוז אלגני (ניו יורק)	1
Allone Abba (Israel)	אלוני אבא (ישראל)	2
Almelo (Netherlands)	אלמלו (הולנד)	1
Almora (India)	אלמורה (הודו)	1
Alonim (Israel)	אלונים (ישראל)	4
Alsace (France)	אלזס (צרפת)	1
Alsheim-Gronau (Rödersheim-Gronau, Germany)	אלשיים-גרונאו (רודרסהיים-גרונאו, גרמניה)	1
Altenkunstadt (Germany)	אלטנקונסטט (גרמניה)	1
Alton (Ill.)	אלטון (אילינוי)	1
Altona (Germany)	אלטונה (גרמניה)	2
Alytus (Lithuania)	אליטא (ליטא)	5
Amersham (England)	אמרסהם (אנגליה)	1
Amherst (Mass.)	אמהרסט (מסצ'וסטס)	1
Amir (Israel)	עמיר (ישראל)	1
Amman (Jordan)	עמאן (ירדן)	2
Ammiad (Israel)	עמיעד (ישראל)	1
Āmol (Iran)	אמול (איראן)	1
Amsterdam (Netherlands)	אמסטרדם (הולנד)	49
Ancona (Italy)	אנקונה (איטליה)	8
Anderson (Ind.)	אנדרסון (אינדיאנה)	1
Andes	הרי האנדס	1
Andhra Pradesh (India)	אנדרה פראדש (הודו)	1
Andreevka (Ilishevskiĭ raĭon, Russia)	אנדרייבקה (מחוז איליישב, רוסיה)	1
Ankara (Turkey)	אנקרה (טורקיה)	3
Ann Arbor (Mich.)	אן ארבור (מישיגן)	3
Annapolis (Md.)	אנפוליס (מרילנד)	2
Annonay (France)	אנוניי (צרפת)	1
Ansbach (Mittelfranken, Germany)	אנסבך (גרמניה)	5
Antigua	אנטיגואה	1
Antopalʹ (Belarus)	אנטופול (בלארוס)	13
Antwerp (Belgium)	אנטורפן (בלגיה)	24
Anykščiai (Lithuania)	אניקשאי (ליטא)	8
Anzio (Italy)	אנציו (איטליה)	2
Aquileia (Italy)	אקוויליה (איטליה)	1
Ar'ara (Israel)	ערערה (ישראל)	1
Arad (Israel)	ערד (ישראל)	7
Arad (Romania)	ארד (רומניה)	4
Aragon (Spain)	ארגון (ספרד)	1
Aran Islands (Ireland)	איי ארן (אירלנד)	1
Arcadia (Calif.)	ארקדיה (קליפורניה)	1
Arequipa (Peru)	ארקיפה (פרו)	1
Arezzo (Italy)	ארצו (איטליה)	1
Arfoud (Morocco)	ארפוד (מרוקו)	1
Argentina	ארגנטינה	83
Arizona	אריזונה	2
Arles (France)	ארל (צרפת)	2
Arlington (Va.)	ארלינגטון (וירג'יניה)	1
Armenia	ארמניה	5
Arolsen (Germany)	ארולזן (גרמניה)	1
Arraba (Israel)	עראבה (ישראל)	1
Arras (France)	אראס (צרפת)	1
Arta (Greece)	ארטה (יוון)	1
Artemivsʹk (Ukraine)	ארטמיבסק (אוקראינה)	3
Artois (France)	ארטואה (צרפת)	1
Asbury Park (N.J.)	אסבורי פארק (ניו ג'רזי)	1
Ascoli Piceno (Italy)	אסקולי פיצ'נו (איטליה)	1
Ashdod (Israel)	אשדוד (ישראל)	6
Ashdot Ya'akov, Me'uhad (Israel)	אשדות יעקב (מאוחד) (ישראל)	1
Ashdot Yaakov (Israel)	אשדות יעקב (ישראל)	3
Asheville (N.C.)	אשוויל (צפון קרולינה)	1
Ashkelon (Israel)	אשקלון (ישראל)	12
Ashkhabad (Turkmenistan)	אשחבד (טורקמניסטן)	1
Ashmi︠a︡ny (Belarus)	אשמיאני (בלארוס)	5
Ashville	אשוויל (ניו יורק)	1
Asmara (Eritrea)	אסמרה (אריתריאה)	4
Asnières-sur-Seine (France)	אניר סור סן (צרפת)	1
Asti (Italy)	אסטי (איטליה)	1
Astoria (New York, N.Y.)	אסטוריה (ניו יורק, ניו יורק)	1
Astrakhan (Russia)	אסטרחן (רוסיה)	1
Asvei︠a︡ (Belarus)	אסווי (בלארוס)	1
Aszód (Hungary)	אסאד (הונגריה)	2
Ataki (Moldova)	אטקי (מולדובה)	3
Atamurat (Turkmenistan)	אטאמוראט (טורקמניסטן)	1
Atarot (Israel)	עטרות (ישראל)	1
Athens (Greece)	אתונה (יוון)	19
Atlanta (Ga.)	אטלנטה (ג'ורג'יה)	8
Atlantic City (N.J.)	אטלנטיק סיטי (ניו ג'רזי)	1
Atlit (Israel)	עתלית (ישראל)	1
Auch (France)	אוש (צרפת)	1
Auckland (N.Z.)	אוקלנד (ניו זילנד)	3
Augsburg (Germany)	אוגסבורג (גרמניה)	2
Augusta (Ga.)	אוגוסטה (ג'ורג'יה)	1
Austin (Tex.)	אוסטין (טקסס)	2
Australia	אוסטרליה	22
Austria	אוסטריה	68
Auteuil (Paris, France)	אוטאווה (פריז, צרפת)	1
Avignon (France)	אויניון (צרפת)	2
Avihayil (Israel)	אביחיל (ישראל)	3
Avila (Spain)	אוילה (ספרד)	1
Avital (Israel)	אביטל (ישראל)	1
Avukka (Israel)	אבוקה (ישראל)	1
Ayrshire (Scotland)	איירשייר (סקוטלנד)	2
Ayyelet Hashahar (Israel)	איילת השחר (ישראל)	10
Azores	האיים האזוריים	1
Babinavichy (Belarus)	בבינוביצ'י (בלארוס)	1
Babruĭsk (Belarus)	בוברויסק (בלארוס)	42
Babylonia	בבל	1
Bacău (Romania)	בקאו (רומניה)	6
Bad Mergentheim (Germany)	באד מרגנטהיים (גרמניה)	1
Bad Reichenhall (Germany)	באד רייכנהאל (גרמניה)	1
Badajoz (Spain)	בדחוס (ספרד)	1
Baden (Austria)	בדן (אוסטריה)	2
Baden-Baden (Germany)	בדן-בדן (גרמניה)	2
Baghdad (Iraq)	בגדאד (עיראק)	92
Bagnols-sur-Cèze (France)	בנולס-סור-סזה (צרפת)	2
Bahía Blanca (Argentina)	באהיה בלנקה (ארגנטינה)	1
Bahrain	בחרין	2
Baia Mare (Romania)	ביה מרה (רומניה)	2
Baiersdorf (Mittelfrankenstadt, Germany)	באירסדורך (גרמניה)	1
Baisogala (Lithuania)	ביסוגלה (ליטא)	2
Baja (Hungary)	ביאה (הונגריה)	3
Baku (Azerbaijan)	באקו (אזרביג'ן)	9
Balassagyarmat (Hungary)	בלשג'רמט (הונגריה)	8
Balbieriškis (Lithuania)	בלבירישוק (ליטא)	1
Balfuriyya (Israel)	בלפורייה (ישראל)	3
Balkány (Hungary)	באלקאן (הונגריה)	1
Balmazújváros (Hungary)	באלמזוייבארוש (הונגריה)	1
Balta (Ukraine)	בלטה (אוקראינה)	12
Bălți (Moldova)	בלץ (מולדובה)	10
Baltimore (Md.)	בולטימור (מרילנד)	22
Bandung (Indonesia)	בנדונג (אינדונזיה)	1
Bangalore (India)	בנגלור (הודו)	2
Banghāzī (Libya)	בנגאזי (לוב)	4
Bangor (Wales)	בנגור (ויילס)	1
Bánovce nad Bebravou (Slovakia)	באנוביצה נאד ברבראבו (סלובקיה)	2
Banská Bystrica (Slovakia)	בנסקה ביסטריצה (סלובקיה)	1
Banyliv (Ukraine)	בנילוב (אוקראינה)	1
Baranavichy (Belarus)	ברנוביץ' (בלארוס)	7
Baranivka (Z︠H︡ytomyrsʹka oblastʹ, Ukraine)	ברניבקה (מחוז ז'יטומיר, אוקראינה)	1
Baranów Sandomierski (Poland)	ברנוב (פולין)	4
Baranowicze (Poland)	ברנוביץ (פולין)	2
Barashi (Iraq)	בראשי (עיראק)	1
Barcelona (Spain)	ברצלונה (ספרד)	17
Bardejov (Slovakia)	ברדיוב (סלובקיה)	4
Barguzin (Russia)	ברגוזין (רוסיה)	1
Bari (Italy)	בארי (איטליה)	2
Barmbek (Hamburg, Germany)	ברמבק (המבורג, גרמניה)	1
Barmen (Wuppertal, Germany)	ברמן (וופרטל, גרמניה)	1
Barysaŭ (Belarus)	בוריסוב (בלארוס)	9
Basel (Switzerland)	בזל (שווייץ)	7
Basrah (Iraq)	בצרה (עיראק)	8
Basses-Alpes (France)	האלפים הנמוכים (צרפת)	1
Bat Galim (Haifa, Israel)	בת גלים (חיפה, ישראל)	1
Bat Yam (Israel)	בת ים (ישראל)	11
Bátorove Kosihy (Slovakia)	בטורקס (סלובקיה)	1
Batta	באת' (אנגליה)	1
Batumi (Georgia)	בתומי (גאורגיה)	3
Bauska (Latvia)	באוסקה (לטביה)	4
Bavaria (Germany)	בוואריה (גרמניה)	1
Bayonne (France)	ביון (צרפת)	1
Bayonne (N.J.)	באיון (ניו ג'רזי)	2
Bayreuth (Germany)	ביירוית (גרמניה)	2
Be'er Toviyya (Israel)	באר טוביה (ישראל)	3
Be'eri (Israel)	בארי (ישראל)	1
Beaconsfield (England)	ביקונספילד (אנגליה)	1
Bechyně (Czech Republic)	בכינה (צ'כיה)	1
Beckum	בקום (וורנדורף, גרמניה)	1
Będzin (Poland)	בנדין (פולין)	11
Beersheba (Israel)	באר שבע (ישראל)	41
Beijing (China)	בייג'ינג (סין)	2
Beira (Mozambique)	ביירה (מוזמביק)	1
Beirut (Lebanon)	בירות (לבנון)	10
Beit Lehem, Judea	בית לחם (גדה מערבית)	1
Békéscsaba (Hungary)	בקשצ'אבה (הונגריה)	1
Belarus	בלארוס	14
Belfast (Northern Ireland)	בלפסט (צפון אירלנד)	8
Belgium	בלגיה	40
Belgrade (Serbia)	בלגרד (סרביה)	7
Belitsa (Hrodzenskai︠a︡ voblastsʹ, Belarus)	בליצה (בלארוס)	1
Belleville (N.J.)	בלוויל (ניו ג'רזי)	1
Beloit (Wis.)	בלויט (ויסקונסין)	1
Belz (Ukraine)	בלז (אוקראינה)	13
Bełżyce (Poland)	בלז'יצה (פולין)	1
Ben Shemen (Israel)	בן שמן (מושב) (ישראל)	2
Bender (Moldova)	בנדרי (מולדובה)	11
Bene Brak (Israel)	בני ברק (ישראל)	29
Bercel (Hungary)	ברצל (הונגריה)	1
Berdi︠a︡nsʹk (Ukraine)	ברדיאנסק (אוקראינה)	2
Berdychiv (Ukraine)	ברדיצ'ב (אוקראינה)	36
Berestechko (Ukraine)	ברסטצ'קה (אוקראינה)	4
Berettyóújfalu (Hungary)	ברטואויפלו (הונגריה)	1
Berez︠h︡any (Ukraine)	בז'ז'ני (אוקראינה)	14
Berezna (Chernihivsʹka oblastʹ, Ukraine)	ברז'נה (מחוז צ'רנוביץ, אוקראינה)	2
Berezne (Ukraine)	ברז'נה (אוקראינה)	1
Bergama (Turkey)	פרגמון (טורקיה)	1
Bergenfield (N.J.)	ברגנפילד (ניו ג'רזי)	1
Berkeley (Calif.)	ברקלי (קליפורניה)	3
Berlin (Germany)	ברלין (גרמניה)	225
Bern (Switzerland)	ברן (שווייץ)	4
Bernburg (Germany)	ברנבורג (גרמניה)	1
Bershadʹ (Ukraine)	ברשד (אוקראינה)	10
Bertinoro (Italy)	ברטינורו (איטליה)	1
Besançon (France)	בסנסון (צרפת)	1
Beshankovichy (Belarus)	ביישינקוביץ (בלארוס)	1
Bessarabia (Moldova and Ukraine)	בסרביה (מולדובה-אוקראינה)	14
Bessarabskai︠a︡ gubernīi︠a︡ (Russia)	מחוז בסרבסקיה (רוסיה)	1
Bet Alfa (Israel)	בית אלפא (ישראל)	3
Bet Hashitta (Israel)	בית השיטה (ישראל)	3
Bet Kama (Israel)	בית קמה (ישראל)	1
Bet Keshet (Israel)	בית קשת (ישראל)	1
Bet Nir (Israel)	בית ניר (ישראל)	2
Bet She'an (Israel)	בית שאן (ישראל)	2
Bet Shemesh (Israel)	בית שמש (ישראל)	2
Bet Yits'hak - Sha'ar Hefer (Israel)	בית יצחק - שער חפר (ישראל)	1
Bet Zera (Israel)	בית זרע (ישראל)	2
Bethlehem (Pa.)	בית לחם (פנסילבניה)	1
Bethlehem (West Bank)	בית לחם (גדה מערבית)	2
Betset (Israel)	בצת (ישראל)	1
Beuthen (Germany)	בויטן (גרמניה)	1
Beverley (England)	בוורלי (אנגליה)	1
Biała Podlaska (Poland)	בילה פודלסקה (פולין)	11
Biała Prudnicka (Poland)	ביאלה פרודניק (פולין)	2
Białystok (Poland)	ביאליסטוק (פולין)	102
Bi︠a︡roza (Bi︠a︡rozaŭski rai︠o︡n, Belarus)	ביארוזה (מחוז ביארוזה, בלארוס)	3
Biecz (Poland)	ביטש (פולין)	1
Bielefeld (Germany)	בילפלד (גרמניה)	1
Bielsk Podlaski (Poland)	בילסק (פולין)	9
Bielsko-Biała (Poland)	ביליץ בילה (פולין)	16
Bieruń Stary (Poland)	בירון סטארי (פולין)	1
Biezun (Poland)	ביז'ון (פולין)	4
Bila T︠S︡erkva (Ukraine)	בילה צרקווה (אוקראינה)	10
Bilbao (Spain)	בלבאו (ספרד)	1
Biłgoraj (Poland)	בילגורי (פולין)	6
Bílichov (Czech Republic)	ביליחוב (צ'כיה)	1
Bingen (Rhineland-Palatinate, Germany)	בינגן (ריינלנד-פאלץ, גרמניה)	1
Binyamina (Israel)	בנימינה (ישראל)	3
Bircza (Poland)	בירצ'ה (פולין)	3
Birkenhead (England)	בירקנהד (אנגליה)	1
Birmingham (Ala.)	בירמינגהם (אלבמה)	2
Birmingham (England)	בירמינגהם (אנגליה)	5
Biržai (Lithuania)	בירזאי (ליטא)	7
Bitha (Israel)	בטחה (ישראל)	1
Bitola (Macedonia)	ביטולה (מקדוניה)	4
Blackburn (England)	בלקבורן (אנגליה)	2
Blackpool (England)	בלקפול (אנגליה)	1
Błaszki (Poland)	בלאשקי (פולין)	2
Bleicherode (Germany)	בלייכרודה (גרמניה)	3
Bloemfontein (South Africa)	בלומפונטיין (דרום אפריקה)	2
Błonie (Warsaw, Poland)	בלוניה (ורשה, פולין) (פולין)	1
Bloomington (Ill.)	בלומינגטון (אילינוי)	1
Bobowa (Poland)	בובוב (פולין)	3
Bobrka (Ukraine)	בוברקה (אוקראינה)	10
Bochnia (Poland)	בוכניה (פולין)	3
Boćki (Poland)	בוצ'קי (פולין)	2
Bodenfelde (Germany)	בודנפלדה (גרמניה)	1
Bodenwerder (Germany)	באדענווערדער (גרמניה)	1
Bodrogkeresztúr (Hungary)	קרסטיר (הונגריה)	1
Bodrum (Turkey)	בודרום (טורקיה)	1
Bodzanów (Poland)	בודזאנוב (פולין)	3
Bogotá (Colombia)	בוגוטה (קולומביה)	4
Bohemia (Czech Republic)	בוהמיה (צ'כיה)	1
Bohorodchany (Ukraine)	בוהורודצ'ני (אוקראינה)	6
Bohuslav (Ukraine)	באהסליב (אוקראינה)	2
Bolekhiv (Ukraine)	בוליחוב (אוקראינה)	7
Bolivia	בוליביה	1
Bollnäs (Sweden)	בולנאס (שבדיה)	1
Bologna (Italy)	בולוניה (איטליה)	9
Bolton (Greater Manchester, England)	בולטון (מנצ'סטר רבתי, אנגליה)	1
Bombay (India)	בומבי (הודו)	1
Bonn (Germany)	בון (גרמניה)	4
Bonyhád (Hungary)	בוניהד (הונגריה)	5
Bordeaux (Aquitaine, France)	בורדו (צרפת)	5
Borken (North Rhine-Westphalia, Germany)	בורקן (נורדריין וסטפליה, גרמניה)	1
Borshchiv (Ternopilʹsʹka oblastʹ, Ukraine)	בורשניב (טרנופיל, אוקראינה)	3
Boryslav (Ukraine)	בוריסלב (אוקראינה)	10
Borzna (Ukraine)	בורזנה (אוקראינה)	1
Boskovice (Czech Republic)	בוסקוביץ (צ'כיה)	6
Bosnia and Hercegovina	בוסניה והרצגובינה	1
Boston (Mass.)	בוסטון (מסצ'וסטס)	27
Botosani (Romania)	בוטושן (רומניה)	7
Bottrop (Germany)	בוטרופ (גרמניה)	1
Boulder (Colo.)	בולדר (קולורדו)	1
Bourges (France)	בורז' (צרפת)	1
Bournemouth (England)	בורנמות (אנגליה)	1
Bouxwiller (France)	בוקסווילר (צרפת)	1
Bradford (West Yorkshire, England)	ברדפורד (יורקשייר המערבית, אנגליה)	1
Braga (Portugal)	בראגה (פורטוגל)	1
Brahin (Belarus)	בראהין (בלארוס)	2
Brăila (Romania)	בראילה (רומניה)	2
Brailiv (Ukraine)	ברהילוב (אוקראינה)	2
Brandenburg (Brandenburg, Germany)	ברנדנבורג (ברנדנבורג, גרמניה)	1
Brańsk (Poland)	ברינסק (פולין)	6
Braslaŭ (Belarus)	בראסלאו (בלארוס)	1
Bratislava (Slovakia)	ברטיסלבה (סלובקיה)	67
Brat︠s︡lav (Ukraine)	ברסלב (אוקראינה)	4
Braunschweig (Germany)	בראונשווייג (גרמניה)	3
Brazil	ברזיל	19
Breda (Netherlands)	ברדה (הולנד)	1
Breisach am Rhein (Germany)	ברייסך אם ריין (גרמניה)	1
Bremen (Germany)	ברמן (גרמניה)	2
Bremerhaven (Germany)	ברמרהאבן (גרמניה)	1
Brescia (Italy)	ברשיה (איטליה)	1
Brest (Belarus)	בריסק (בלארוס)	7
Brest (France)	ברסט (צרפת)	2
Bri︠a︡nsk (Russia)	בריאנסק (רוסיה)	5
Briceni (Moldova)	בריצ'ני (מולדובה)	6
Bridgeport (Conn.)	ברידג'פורט (קונטיקט)	2
Brieg (Germany)	בריג (גרמניה)	1
Brighton (England)	ברייטון (אנגליה)	4
Brisbane (Qld.)	בריסביין (אוסטרליה)	1
Bristol (England)	בריסטול (אנגליה)	4
British Columbia	קולומביה הבריטית	1
Brixton (London, England)	בריקסטון (לונדון, אנגליה)	1
Brno (Czech Republic)	ברנו (צ'כיה)	10
Brockton (Mass.)	ברוקטון (מסצ'וסטס)	1
Brody (Ukraine)	ברודי (אוקראינה)	91
Brok (Ostrołęka, Poland)	ברוק (אוסטרולקה, פולין)	2
Bromberg	בידגושץ' (פולין)	1
Bromley (London, England)	ברומלי (לונדון, אנגליה)	1
Bronx (New York, N.Y.)	ברונקס (ניו יורק, ניו יורק)	11
Brookline (Mass.)	ברוקליין (מסצ'וסטס)	5
Brooklyn (New York, N.Y.)	ברוקלין (ניו יורק, נ.י.)	61
Brovary (Ukraine)	ברובארי (אוקראינה)	1
Brownsville (New York, N.Y.)	ברונזויל (ניו יורק, ניו יורק)	2
Brtnice (Czech Republic)	ברטניץ (צ'כיה)	1
Bruchhausen (Neuwied, Germany)	ברוכהאוזן (נויוויד, גרמניה)	1
Bruchsal (Germany)	ברוכסאל (גרמניה)	1
Bruges (Belgium)	ברוז' (בלגיה)	1
Brussels (Belgium)	בריסל (בלגיה)	14
Brzeg Dolny (Poland)	ברזג דולני (פולין)	1
Brześć Kujawski (Poland)	בז'שץ' קויאוסקי (פולין)	2
Brześć Litewski (Poland)	ברסט ליטובסק (פולין)	29
Brzesko (Poland)	בריגל בז'סקו (פולין)	6
Bucecea (Romania)	בוצ'צ'אה (רומניה)	1
Buchach (Ukraine)	בוצ'ץ' (אוקראינה)	20
Bucharest (Romania)	בוקרסט (רומניה)	43
Buda (Hungary)	בודה (הונגריה)	1
Budaniv (Ukraine)	בודניב (אוקראינה)	1
Budapest (Hungary)	בודפסט (הונגריה)	90
Büdesheim (Germany)	בודסהיים (גרמניה)	1
Buenos Aires (Argentina)	בואנוס איירס (ארגנטינה)	63
Buffalo (N.Y.)	באפלו (ניו יורק)	7
Bugojno (Bosnia and Hercegovina : Opština)	בוגוינו (בוסניה הרצוגובינה)	1
Buhusi (Romania)	בוחוש (רומניה)	1
Bukachivtsi (Ukraine)	בוקצ'ביץ (אוקראינה)	3
Bukhoro (Uzbekistan)	בוכרה (אוזבקיסטן)	11
Bukovina	בוקובינה (רומניה-אוקראינה)	1
Bukovina (Romania and Ukraine)	בוקובינה (רומניה-אוקראינה)	10
Bukowsko (Poland)	בוקובסק (פולין)	3
Bulgaria	בולגריה	56
Burdujeni (Suceava, Romania)	בורדוזשן (סוצ'אבה, רומניה)	1
Burgas (Bulgaria)	בורגז (בולגריה)	2
Burgenland (Austria)	בורגנלנד (אוסטריה)	2
Burgkunstadt (Germany)	בורגקונשטט (גרמניה)	1
Burgos (Spain)	בורגוס (ספרד)	1
Burgpreppach (Germany)	בורגפרפך (גרמניה)	1
Burgundy (France)	בורגנדי (צרפת)	1
Bursa (Turkey)	בורסה (תורכיה)	1
Bursa İli (Turkey)	בורסה אילי (טורקיה)	3
Burshtyn (Ukraine)	בורשטין (אוקראינה)	1
Burton upon Trent (England)	ברטון על טרנט (אנגליה)	1
Burundi	בורונדי	1
Bury St. Edmunds (England)	ברי סנט אדמונדס (אנגליה)	2
Busʹk (Ukraine)	בוסק (אוקראינה)	3
Busko-Zdrój (Poland)	בוסקו זדרוי (פולין)	1
Butrimonys (Lithuania)	בוטרימוניס (ליטא)	4
Butte (Mont.)	ביוט (מונטנה)	4
Byala	ביליץ בילה (פולין)	1
Byaroza (Belarus)	ברעזי (בלארוס)	10
Bychawa (Poland)	ביחוה (פולין)	1
Byten (Belarus)	ביטן (בלארוס)	5
Bytom (Poland)	ביטום (פולין)	4
Caerleon (Wales)	קירליאון (ויילס)	1
Cagliari (Italy)	קליארי (איטליה)	1
Cairo (Egypt)	קהיר (מצרים)	36
Călărași (Moldova : Raionul)	קאלארשי (מולדובה : מחוז)	4
Calcutta (India)	כלכתה (הודו)	7
Calgary (Alta.)	קלגרי (אלברטה)	1
California	קליפורניה	10
California, Southern	דרום קליפורניה	1
Calw (Germany)	קאלוו (גרמניה)	1
Camberwell (London, England)	קמברוול (לונדון, אנגליה)	2
Cambridge (England)	קמברידג' (אנגליה)	6
Cambridge (Mass.)	קמברידג' (מסצ'וסטס)	8
Cambridge (Md.)	קמברידג' (מרילנד)	1
Camden (N.J.)	קמדן (ניו ג'רזי)	1
Camden (Ohio)	קמדן (אוהיו)	1
Cameroon	קמרון	1
Canada	קנדה	28
Canary Islands	האיים הקנריים	1
Canterbury (England)	קנטרברי (אנגליה)	1
Cape May Point (N.J.)	קייפ מיי פוינט (ניו ג'רזי)	1
Cape Town (South Africa)	קייפטאון (דרום אפריקה)	7
Caracas (Venezuela)	קראקס (ונצואלה)	2
Caransebeș (Romania)	קראנסבס (רומניה)	1
Carbondale	קרבונדייל (אילינוי)	1
Carcassonne (France)	קרקסון (צרפת)	1
Cardiff (Wales)	קארדיף (ויילס)	2
Carei (Romania)	קרולה (רומניה)	1
Carpentras (France)	קרפנטרס (צרפת)	1
Casablanca (Morocco)	קזבלנקה (מרוקו)	24
Casale Monferrato (Italy)	קזאלה מונפראטו (איטליה)	2
Castleford (England)	קסטלפורד (אנגליה)	1
Catalonia (Spain)	קטלוניה (ספרד)	4
Catania, Sicily	קטניה (איטליה)	1
Caucasus	קוקז	1
Cehu Silvaniei (Romania)	סילאדי טשעה (רומניה)	1
Celje (Slovenia)	סלג'ה (סלובניה)	1
Celle (Germany)	צלה (גרמניה)	1
Ceneda (Italy)	סנדה (איטליה)	1
Černá Hora (Blansko District, Czech Republic)	צ'רנה הורה (צ'כיה)	1
Cernăuți (Romania)	צ'רנוביץ (רומניה)	1
Cesena (Italy)	צ'זנה (איטליה)	2
Český Těšín (Czech Republic)	צ'סקי טסין (צ'כיה)	1
Ceuta (Spain)	סאוטה (ספרד)	2
Chaco (Argentina)	צ'אקו (ארגנטינה)	1
Changdu Diqu (China)	צ'נגדו דיקו (סין)	1
Chapel Hill (N.C.)	צ'פל היל (צפון קרולינה)	1
Charente (France)	שראנט (צרפת)	1
Charleston (S.C.)	צ'רלסטון (דרום קרולינה)	2
Charlotte (N.C.)	שרלוט (צפון קרולינה)	1
Chartres (France)	שארטר (צרפת)	1
Chashniki (Belarus)	צ'שניקי (בלארוס)	7
Château-Thierry (France)	שטו-טיירי (צרפת)	1
Châteauroux (France)	שאטורו (צרפת)	1
Chatham (Ont.)	צ'טהם (אונטריו)	1
Chattanooga (Tenn.)	צ'טנוגה (טנסי)	2
Chęiny (Województwo Święokrzyskie, Poland)	חנטשין (קילצה, פולין)	1
Cheli︠a︡binskai︠a︡ oblastʹ (Russia)	מחוז צ'ליאבינסק (רוסיה)	1
Chełm (Lublin, Poland)	חלם (לובלין, פולין)	4
Cheltenham (England)	צ'לטנהם (אנגליה)	2
Chemnitz (Germany)	קמניץ (גרמניה)	5
Cherbourg (France)	שרבור (צרפת)	1
Cherchell (Algeria)	שרשל (אלג'יריה)	1
Cherkasy (Ukraine)	צ'רקאסי (אוקראינה)	2
Chernihiv (Ukraine)	צ'רנייב (אוקראינה)	13
Chernivt︠s︡i (Ukraine)	צ'רנוביץ (אוקראינה)	32
Chervonohrad (Ukraine)	קריסנפוליו (אוקראינה)	5
Cheshire (England)	צ'שייר (אנגליה)	2
Chicago (Ill.)	שיקגו (אילינוי)	65
Chihuahua (Chihuahua, Mexico)	צ'יוואווה (צ'יוואווה, מקסיקו)	1
Chile	צ'ילה	16
China	סין	21
Chios (Greece)	כיוס (יוון)	1
Chișinău (Moldova)	קישינב (מולדובה)	46
Chiswick (London, England)	צ'יזיק (לונדון, אנגליה)	2
Chmielnik	חמלניצקי (אוקראינה)	4
Chmielnik (Poland)	חמלניק (פולין)	1
Chŏlla-namdo (Korea)	צ'ולה נאמדו (קוריאה)	1
Chongqing (China)	צ'ונגצ'ינג (סין)	1
Chornobylʹ (Ukraine)	צ'רנוביל (אוקראינה)	5
Chortkiv (Ukraine)	צ'ורטקוב (אוקראינה)	6
Chorzów (Województwo Śląskie, Poland)	חוז'וב (פולין)	3
Chrzanów (Poland)	כשנוב (פולין)	4
Chudniv (Ukraine)	צ'ודניב (אוקראינה)	2
Chufut-Kale (Ukraine)	צ'ופוט קלעה (אוקראינה)	2
Ciechanów (Poland)	צ'כנוב (פולין)	3
Ciechanowiec (Poland)	ציחנוביץ (פולין)	6
Cieszanow (Poland)	צישינוב (פולין)	3
Cieszyn (Województwo Śląskie, Poland)	צ'שין (מחוז שלזיה, פולין)	1
Cincinnati (Ohio)	סינסינטי (אוהיו)	10
Clara (Argentina)	קלרה (ארגנטינה)	1
Clermont-Ferrand (France)	קלרמונט פראנד (צרפת)	1
Cleveland (Ohio)	קליבלנד (אוהיו)	18
Clinton (Mass.)	קלינטון (מסצ'וסטס)	1
Clonmel (Ireland)	קלונמל (אירלנד)	1
Cluj-Napoca (Romania)	קלוז'-נאפוקה (רומניה)	11
Cochin (India)	קוצ'ין (הודו)	1
Colchester (Conn.)	קולצ'סטר (קונטיקט)	1
Colchester (England)	קולצ'סטר (אנגליה)	1
Colmar (France)	קולמאר (צרפת)	1
Cologne (Germany)	קלן (גרמניה)	29
Colombia	קולומביה	5
Colonia Lucienville (Argentina)	קולוניה לוסיאנויל (ארגנטינה)	1
Colorado	קולורדו	2
Columbia (Md.)	קולומביה (מרילנד)	1
Columbus (Ohio)	קולומבוס (אוהיו)	1
Como (Italy)	קומו	1
Congo (Brazzaville)	קונגו (ברזוויל)	1
Connecticut	קונטיקט	5
Connellsville (Pa.)	קונלסוויל	1
Constanţa (Romania)	קונסטנצה (רומניה)	1
Constantine (Algeria)	קונסטנטין (אלג'יריה)	6
Constantinople	קונסטנטינופול	4
Copenhagen (Denmark)	קופנהגן (דנמרק)	17
Córdoba (Argentina)	קורדובה (ארגנטינה)	1
Córdoba (Spain)	קורדובה (ספרד)	1
Cork (Ireland)	קורק (אירלנד)	2
Corrientes (Argentina)	קוריינטס (ארגנטינה)	1
Corsica (France)	קורסיקה (צרפת)	1
Cosenza (Italy)	קוסנצה (איטליה)	1
Costa Rica	קוסטה ריקה	2
Courbevoie (France)	קורבבוי (צרפת)	1
Coventry (England)	קובנטרי (אנגליה)	2
Coweta County (Ga.)	מחוז קווטה (ג'ורג'יה)	1
Craiova (Romania)	קריובה (רומניה)	1
Cremona (Italy)	קרמונה (איטליה)	1
Crete (Greece)	כרתים (יוון)	2
Croatia	קרואטיה	9
Croydon (London, England)	קרוידון (לונדון, אנגליה)	1
Csenger (Hungary)	צ'נגר (הונגריה)	1
Cuneo (Italy)	קונאו (איטליה)	1
Curaçao (Netherlands Antilles)	קוראסאו (האנטילים ההולנדיים)	1
Cyprus	קפריסין	5
Czech Republic	צ'כיה	69
Czechoslovakia	צ'כוסלובקיה	13
Czeladź (Poland)	צילדז (פולין)	3
Częstochowa (Poland)	צ'נסטוחובה (פולין)	19
Czyżewo (Poland)	צ'יזבה (פולין)	1
Dąbrowa Białostocka (Poland)	דומברובה ביאלוסטוקה (פולין)	2
Dabrowa Gornicza (Poland)	דומברובה גורניצ'ה (פולין)	2
Dąbrowa Tarnowska (Poland : Powiat)	דומברובה טרנובסקה (פולין : מחוז)	3
Dafna (Israel)	דפנה (ישראל)	2
Dagenham (London, England)	דגנהאם (לונדון, אנגליה)	1
Dagestan (Russia)	דגסטן (רוסיה)	2
Dair el Asad (Israel)	דיר אל-אסד (ישראל)	2
Daliyya (Israel)	דליה (ישראל)	1
Dallas (Tex.)	דאלאס (טקסס)	7
Damascus (Syria)	דמשק (סוריה)	22
Damietta (Egypt)	דמיאט (מצרים)	1
Danzig (Germany)	דנציג (גרמניה)	3
Darabani (Romania)	דרבן (רומניה)	1
Darjeeling (India)	דרג'ילינג (הודו)	1
Darmstadt (Germany)	דרמשטט (גרמניה)	2
Dartford (England)	דרטפורד (אנגליה)	1
Daugavpils (Latvia)	דוינסק (לטביה)	36
Daugeliškiai (Belarus)	דוגאלישוק (בלארוס)	1
Daŭhinava (Minskai︠a︡ voblastsʹ, Belarus)	דלהינוב (מחוז מינסק, בלארוס)	2
Davenport	דבנפורט (איווה)	1
Davos (Switzerland)	דאבוס (שווייץ)	1
Davyd-Haradok (Belarus)	דויד הורודוק (בלארוס)	3
Dayton (Ohio)	דייטון (אוהיו)	2
Dearborn (Mich.)	דירבורן (מישיגן)	1
Dęblin (Lublin, Poland)	דבלין (לובלין, פולין)	2
Debrecen (Hungary)	דברצן (הונגריה)	8
Dedham (Mass.)	דדהם (מסצ'וסטס)	1
Deganya Alef (Israel)	דגניה א' (ישראל)	4
Deganya Bet (Israel)	דגניה ב' (ישראל)	3
Dej (Romania)	דז' (רומניה)	7
Delmenhorst (Germany)	דלמנהורסט (גרמניה)	1
Demmin (Germany)	דמין (גרמניה)	1
Denmark	דנמרק	35
Denver (Colo.)	דנוור (קולורדו)	2
Derbent (Russia)	דרבנט (רוסיה)	2
Derbyshire (England)	דרבישייר (אנגליה)	2
Derecske (Hungary)	דרצ'קה (הונגריה)	1
Derry (Northern Ireland)	דרי (צפון אירלנד)	3
Des Moines (Iowa)	דה מוין (איווה)	3
Dešenice (Czech Republic)	דז'ניץ (צ'כיה)	1
Dessau (Halle, Germany)	דסאו (הלה, גרמניה)	10
Detmold (Germany)	דטמולד (גרמניה)	3
Detroit (Mich.)	דטרויט (מישיגן)	10
Deutschkreutz (Austria)	דויטש קרויץ (אוסטריה)	5
Devon (England)	דבון (אנגליה)	2
Dhamār (Yemen)	דמאר (תימן)	3
Dhārwār (India)	דהארוואר (הודו)	1
Diespeck (Germany)	דיספק (גרמניה)	1
Dieuze (France)	דיאז (צרפת)	1
Dimona (Israel)	דימונה (ישראל)	5
Dīwānīyah (Iraq)	דיוואניה (עיראק)	1
Döbeln (Germany)	דובלן (גרמניה)	1
Dobříš (Czech Republic)	דובריס (צ'כיה)	2
Dobrzany (Poland)	דובז'אני (פולין)	1
Dobrzyń nad Wisłą (Poland)	דובז'ין נאד ויסלא (פולין)	3
Dolina	דאלינע (אוקראינה)	7
Donet︠s︡ʹk (Ukraine)	דוניצק (אוקראינה)	1
Dorking (England)	דורקינג (אנגליה)	1
Dorot (Israel)	דורות (ישראל)	1
Dorset (England)	דורסט (אנגליה)	1
Dorsten (Germany)	דורסטן (גרמניה)	1
Dortmund (Germany)	דורטמונד (גרמניה)	3
Dovrat (Israel)	דוברת (ישראל)	2
Drahichyn (Belarus)	דרוהיטשין (בלארוס)	2
Dresden (Germany)	דרזדן (גרמניה)	19
Drohiczyn (Poland)	דרוהיצ'ין (פולין)	1
Drohobych (Ukraine)	דרוהוביץ (אוקראינה)	21
Drohobycz, Galicia	דרוהוביץ (אוקראינה)	1
Drui︠a︡ (Belarus)	דרויה (בלארוס)	3
Dubăsari (Moldova)	דובוסרי (מולדובה)	3
Dubí (Czech Republic)	דובי (צ'כיה)	1
Dubienka (Poland)	דוביינקה (פולין)	2
Dublin (Ireland)	דבלין (אירלנד)	22
Dubno (Ukraine)	דובנו (אוקראינה)	7
Dubova (Umansʹkyĭ raĭon, Ukraine)	דובובה (מחוז אומאנסק, אוקראינה)	2
Dubrovnik (Croatia)	דוברובניק (קרואטיה)	1
Duisburg (Germany)	דיסבורג (גרמניה)	1
Dukla (Poland)	דוקלה (פולין)	6
Duluth (Minn.)	דולות (מינסוטה)	1
Dunaïvt︠s︡i (Ukraine)	דוניביץ (אוקראינה)	7
Dunajská Streda (Slovakia)	דונסרדהלי (סלובקיה)	16
Dunayevtsy	דוניביץ (אוקראינה)	1
Dundee (Scotland)	דנדי (סקוטלנד)	1
Dupnit︠s︡a (Bulgaria)	דופניצה (בולגריה)	1
Durban (South Africa)	דרבן (דרום אפריקה)	1
Durham (England)	דורהם (אנגליה)	1
Durham (N.C.)	דורהם (צפון קרולינה)	2
Dusetos (Lithuania)	דוסיאט (ליטא)	2
Dushanbe (Tajikistan)	דושנבה (טג'יקיסטן)	2
Düsseldorf (Germany)	דיסלדורף (גרמניה)	14
Dyatlovo (Belarus)	ז'טל (בלארוס)	4
Dynów (Poland)	דינוב (פולין)	6
Dzeraunaia (Minskaia voblasts, Belarus)	דזרז'ינסק (בלארוס)	8
Dzerzhinsk	דזרז'ינסק (רוסיה)	4
Działoszyce (Poland)	דזילושיץ (פולין)	3
Dzi︠a︡tlava (Belarus)	דזיאטלבה (בלארוס)	3
Dzierżoniów (Poland)	דז'רזונוף (פולין)	1
Dzisna (Belarus)	דזיסנה (בלארוס)	7
East Lothian (Scotland)	מזרח לותיאן (סקוטלנד)	1
East New York (New York, N.Y.)	מזרח ניו יורק (ניו יורק, ניו יורק)	1
Easthampton (Mass.)	איסטהמפטון (מסצ'וסטס)	1
Edinburgh (Scotland)	אדינבורו (סקוטלנד)	20
Edineț (Moldova : Raionul)	אדינץ (מולדובה : מחוז)	2
Edirne (Turkey)	אדירנה (תורכיה)	20
Efrat (West Bank)	אפרת (גדה מערבית)	1
Eger	אגר (הונגריה)	1
Eger (Hungary)	אגר (הונגריה)	1
Egypt	מצרים	39
Eisenach (Germany)	אייזנאך (גרמניה)	2
Eisenstadt (Austria)	איזנשטט (אוסטריה)	6
Eišiškės (Lithuania)	אישישוק (ליטא)	10
Eisleben (Germany)	אייסלבן (גרמניה)	1
Ekaterinburg (Russia)	יקטרינבורג (רוסיה)	1
El Paso (Tex.)	אל פאסו (טקסס)	2
El'ad (Israel)	אלעד (ישראל)	3
Elat (Israel)	אילת (ישראל)	9
Elberfeld (Germany)	אלברפלד (גרמניה)	3
Elbeuf (France)	אלבף (צרפת)	1
Elbląg (Poland)	אלבלג (פולין)	2
Eleusis (Greece)	אלזיס (יוון)	1
Elmshorn (Germany)	אלמסהורן (גרמניה)	1
Elwood	אלווד (ניו ג'רזי)	1
Elyakhin (Israel)	אליכין (ישראל)	1
Emden (Germany)	אמדן (גרמניה)	3
Emden (Lower Saxony, Germany)	אמדן (סקסוניה תחתית, גרמניה)	1
Empoli (Italy)	אמפולי (איטליה)	1
En Dor (Israel)	עין דור (ישראל)	3
En Gedi (Israel)	עין גדי (ישראל)	2
En ha-Mifrats (Israel)	עין המפרץ (ישראל)	4
En Hahoresh (Israel)	עין החורש (ישראל)	6
En Hanetsiv (Israel)	עין הנציב (ישראל)	3
En Harod (Israel)	עין חרוד (ישראל)	12
En Harod Ihud (Israel)	עין חרוד איחוד (ישראל)	1
En Harod Me'uhad (Israel)	עין חרוד מאוחד (ישראל)	3
En Hashofet (Israel)	עין השופט (ישראל)	3
En Hod (Israel)	עין הוד (ישראל)	2
En Shemer (Israel)	עין שמר (ישראל)	7
En Ziwan (Israel)	עין זיון (ישראל)	1
En-Zetim (Israel)	עין זיתים (ישראל)	1
Enat (Israel)	עינת (ישראל)	3
England	אנגליה	159
Enkhuizen (Netherlands)	אנקהויזן (הולנד)	1
Enniskillen (Northern Ireland)	אניסקילן (צפון אירלנד)	1
Enschede (Netherlands)	אנסחדה (הולנד)	1
Eperjes (Hungary)	אפרז (הונגריה)	1
Eppingen (Germany)	אפינגן (גרמניה)	1
Erez (Israel)	ארז (ישראל)	1
Erfurt (Germany)	ארפורט (גרמניה)	3
Erlangen (Germany)	ארלנגן (גרמניה)	3
Eschwege (Germany)	אשווגה (גרמניה)	1
Escondido (Calif.)	אסקונדידו (קליפורניה)	1
Essaouira (Morocco)	מוגדור (מרוקו)	11
Essen (Germany)	אסן (גרמניה)	4
Essingen (Südliche Weinstrasse, Germany)	אסינגן (סודליש וויינשטרסה, גרמניה)	1
Esslingen am Neckar (Germany)	אסלינגן אם נקאר (גמניה)	1
Estella (Spain)	אסטלה (ספרד)	1
Estonia	אסטוניה	1
Ethiopia	אתיופיה	13
Etoile	אטואל-סור-רון (צרפת)	1
Euclid (Ohio)	יוקליד (אוהיו)	1
Eure (France)	אר (צרפת)	1
Evanston (Ill.)	אבנסטון (אילינוי)	1
Evansville (Ind.)	אוונסוויל (אינדיאנה)	1
Evpatoria (Ukraine)	יבפטוריה (אוקראינה)	2
Evron (Israel)	עברון (ישראל)	2
Exeter (England)	אקסטר (אנגליה)	1
Exeter (N.H.)	אקסטר (ניו המפשייר)	1
Falenica (Warsaw, Poland)	פלניץ (פולין)	3
Fălești (Moldova)	פאלשטי (מולדובה)	2
Fălticeni (Romania)	פאלטיצ'ני (רומניה)	3
Famagusta (Cyprus)	פמגוסטה (קפריסין)	1
Fano (Italy)	פאנו (איטליה)	1
Far Rockaway (New York, N.Y.)	פאר רוקאווי (ניו יורק, ניו יורק)	1
Fastiv (Ukraine)	פסטיב (אוקראינה)	2
Fehérgyarmat (Hungary)	פהרג'רמט (הונגריה)	2
Ferrara (Italy)	פררה (איטליה)	12
Ferrol del Caudillo (Spain)	פרול דל קאודילו (ספרד)	1
Fife (Scotland)	פייף (סקוטלנד)	1
Figuig (Morocco)	פיגויג (מרוקו)	1
Finland	פינלנד	31
Flanders	פלנדריה	17
Flehingen (Germany)	פלהינגן (גרמניה)	1
Flint (Mich.)	פלינט (מישיגן)	1
Florence (Italy)	פירנצה (איטליה)	31
Florida	פלורידה	2
Florida, Mo.	פלורידה	1
Floss (Germany)	פלוס (גרמניה)	1
Flushing (New York, N.Y.)	פלשינג (ניו יורק)	1
Focsani (Romania)	פוקשאן (רומניה)	1
Fond du Lac (Wis.)	פונד דו לק (ויסקונסין)	1
Fond du Lac, Wisconsin	פונד דו לק (ויסקונסין)	1
Fontainebleau (France)	פונטנבלו (צרפת)	2
Fordon (Poland)	פורדון (פולין)	1
Fort Sill (Okla.)	פורט סיל (אוקלהומה)	1
Fort Wayne (Ind.)	פורט וויין (אינדיאנה)	1
Fort Worth (Tex.)	פורט וורת' (טקסס)	1
Fossano (Italy)	פוססנו (איטליה)	1
Foxboro (Mass.)	פוקסבורו (מסצ'וסטס)	1
France	צרפת	344
Frankfurt am Main (Germany)	פרנקפורט דמיין (גרמניה)	68
Frankfurt an der Oder (Germany)	פרנקפורט על האודר (גרמניה)	6
Franklin County (Pa.)	מחוז פרנקלין (פנסילבניה)	1
Fraser River Valley (B.C.)	עמק נהר פרייזר (בריטיש קולומביה)	1
Frauenkirchen (Austria)	פראואנקירכן (אוסטריה)	2
Freiberg (Germany)	פרייברג (גרמניה)	2
Freiburg im Breisgau (Germany)	פרייבורג בברייסגאו (גרמניה)	3
Fresno (Calif.)	פרזנו (קליפורניה)	3
Friedrichstadt	פרידריכסשטדט (שלזוויג-הולשטיין, גרמניה)	1
Friedrichstadt, Jaunjelgava	פרידריכסשטדט (שלזוויג-הולשטיין, גרמניה)	1
Frumușica (Romania)	פרומושיקה (רומניה)	2
Fulda (Germany)	פולדה (גרמניה)	6
Fundukleevka (Ukraine)	פונדאקליבקה (אוקראינה)	1
Fürth (Germany)	פירת (גרמניה)	24
Fusṭāṭ (Cairo, Egypt)	פוסטט (קהיר, מצרים)	4
Ga'ash (Israel)	געש (ישראל)	1
Gąbin (Poland)	גומבין (פולין)	1
Găești (Romania)	גאסטי (רומניה)	1
Gailingen (Germany)	גילינגן (גרמניה)	1
Gainesville (Tex.)	גיינסוויל (טקסס)	1
Gal'ed (Israel)	גלעד (ישראל)	2
Gal'on (Israel)	גלאון (ישראל)	1
Galanta (Slovakia)	גלנטה (סלובקיה)	2
Galați (Romania)	גאלאץ (רומניה)	6
Galesburg (Ill.)	גיילסבורג (אילינוי)	1
Galicia (Poland and Ukraine)	גליציה (פולין-אוקראינה)	149
Galilee (Israel)	גליל (ישראל)	1
Galilee, Lower (Israel)	גליל תחתון (ישראל)	1
Galilee, Upper (Israel)	גליל עליון (ישראל)	1
Gallipoli (Turkey)	גליפולי (טורקיה)	2
Gan Shemu'el (Israel)	גן שמואל (ישראל)	8
Gard (France)	גארד (צרפת)	1
Gargždai (Lithuania)	גורזד (ליטא)	2
Gary (Ind.)	גארי (אינדיאנה)	2
Gateshead (England)	גייטסהד (אנגליה)	1
Gaza	עזה (רצועת עזה)	1
Gaza (Gaza Strip)	עזה (רצועת עזה)	2
Gaza, Palestine	עזה (רצועת עזה)	1
Gaziantep (Turkey)	גזיאנטפ (טורקיה)	1
Gdańsk (Poland)	גדנסק (פולין)	16
Gdov (Russia)	גדוב (רוסיה)	1
Gdynia (Poland)	גדיניה (פולין)	1
Gedera (Israel)	גדרה (ישראל)	6
Geldern (Germany)	גלדרן (גרמניה)	1
Genazzano (Italy)	גנאצנו (איטליה)	1
Geneva (Switzerland)	ז'נבה (שווייץ)	12
Genoa (Italy)	ג'נואה (איטליה)	10
Georgia	ג'ורג'יה	6
Germantown (Philadelphia, Pa.)	ג'רמנטאון (פילדלפיה, פנסילבניה)	1
Gerona (Spain)	גרונה (ספרד)	6
Gesher (Israel)	גשר (ישראל)	1
Geva (Israel)	גבע (ישראל)	1
Gevat (Israel)	גבת (ישראל)	3
Ghana	גאנה	3
Ghardaïa (Algeria)	גרדיה (אלג'יריה)	1
Ghent (Belgium)	גנט (בלגיה)	3
Gibraltar	גיברלטר	5
Ginnegar (Israel)	גיניגר (ישראל)	1
Gironde (France)	ז'ירונד (צרפת)	2
Giv'at Ada (Israel)	גבעת עדה (ישראל)	3
Giv'at Brener (Israel)	גבעת ברנר (ישראל)	14
Giv'at Hashelosha (Israel)	גבעת השלושה (ישראל)	1
Giv'at Hayyim (Israel)	גבעת חיים (מאוחד) (ישראל)	6
Giv'at Shemu'el (Israel)	גבעת שמואל (ישראל)	2
Giv'atayim (Israel)	גבעתיים (ישראל)	23
Glasgow (Scotland)	גלזגו (סקוטלנד)	12
Glazov (Russia)	גלזוב (רוסיה)	1
Gleiwitz (Germany)	גלייוויץ (גרמניה)	1
Glendale (Calif.)	גלנדייל (קליפורניה)	1
Gliwice (Poland)	גליביצה (פולין)	3
Glogau (Germany)	גלוגאו (גרמניה)	1
Gloucestershire (England)	גלוסטרשייר (אנגליה)	1
Gloversville (N.Y.)	גלוברסוויל (ניו יורק)	1
Goddelau (Germany)	גודלאו (גרמניה)	1
Golčův Jeníkov (Czech Republic)	גולצוב יניקוב (צ'כיה)	2
Gondar (Ethiopia)	גונדר (אתיופיה)	3
Goniądz (Poland)	גוניונדז (פולין)	7
Goole (England)	גול (אנגליה)	1
Goor (Netherlands)	חור (הולנד)	1
Góra Kalwaria (Poland)	גור (פולין)	5
Goraj (Poland)	גוריי (פולין)	1
Gori	גורי (גאורגיה)	1
Gori (Georgia)	גורי (גאורגיה)	1
Gorinchem (Netherlands)	חורינכם (הולנד)	1
Gorizia (Italy)	גוריציה (איטליה)	2
Gorlice (Poland)	גורליץ (פולין)	11
Görlitz (Dresden, Germany)	גרליץ (דרזדן, גרמניה)	1
Gostiņi (Latvia)	גוסטיני (לטביה)	2
Gostynin (Poland)	גוסטינין (פולין)	1
Göteborg (Sweden)	גוטברג (שבדיה)	1
Göttingen (Germany)	גוטינגן (גרמניה)	1
Gourrama (Morocco)	גוראמה (מרוקו)	1
Grabowiec (Poland)	גרבוביץ (פולין)	1
Gradisca d'Isonzo (Italy)	גרדיסקה ד'איזונצו (איטליה)	1
Gradiska	גרדיסקה ד'איזונצו (איטליה)	1
Grajewo (Poland)	גריוה (פולין)	13
Granada (Spain)	גרנדה (ספרד)	1
Grand Island (Neb.)	גרנד איילנד (נברסקה)	1
Grand Rapids (Mich.)	גרנד רפידס (מישיגן)	5
Great Britain	בריטניה	11
Great Yarmouth (England)	גרייט ירמות' (אנגליה)	2
Greece	יוון	5
Greenville (Miss.)	גרינוויל (מיסיסיפי)	1
Greenville (S.C.)	גרינוויל (דרום קרולינה)	1
Greenwich (Conn.)	גריניץ' (קונטיקט)	1
Greenwich (London, England)	גריניץ' (לונדון, אנגליה)	1
Greenwich Village (New York, N.Y.)	גריניץ' וילג' (ניו יורק, ניו יורק)	1
Greenwich Village, NY	גריניץ' וילג' (ניו יורק, ניו יורק)	1
Greiz (Germany)	גרייץ (גרמניה)	1
Grenada	גרנדה	3
Grenoble (France)	גרנובל (צרפת)	3
Grodzisk Mazowiecki (Poland)	גרודז'יסק מזובייצקי (פולין)	2
Grodzisk Wielkopolski (Poland)	גרידיץ (פולין)	1
Grodzisko (Poland)	גרודז'יסק (פולין)	1
Groningen (Netherlands)	חרונינגן (הולנד)	1
Grybów (Poland)	גריבוב (פולין)	2
Guadalajara (Spain)	גוודלחרה (ספרד)	1
Guanajuato (Mexico)	גואנחואטו (מקסיקו)	1
Guatemala	גואטמלה	1
Güessing (Austria)	גסינג (אוסטריה)	1
Guildford (England)	גילדפורד (אנגליה)	1
Guipúzcoa (Spain)	גויפוזקואה (ספרד)	1
Gujarat (India)	גוג'ראט (הודו)	1
Gulpāyigān (Iran)	גולפאיגאן (איראן)	1
Gura Humorului (Romania)	גורה הומורה (רומניה)	2
Guttstadt (Germany)	גוטשטדט (גרמניה)	1
Gyöngyös (Hungary)	ג'ונג'וש (הונגריה)	1
Győr (Hungary)	גיור (הונגריה)	2
Haarlem (Netherlands)	הארלם (הולנד)	4
Hackney (London, England)	האקני (לונדון, אנגליה)	1
Hadera (Israel)	חדרה (ישראל)	26
Hague (Netherlands)	האג (הולנד)	8
Haguenau (France)	הגנאו (צרפת)	1
Hahotrim (Israel)	החותרים (ישראל)	1
Haifa (Israel)	חיפה (ישראל)	297
Haiti	האיטי	2
Hajduböszörmény (Hungary)	בסרמן (הונגריה)	1
Hajdúhadház (Hungary)	האדהאז (הונגריה)	1
Hajdúnánás (Hungary)	הידוננש (הונגריה)	2
Hajdúsámson (Hungary)	שמששאן (הונגריה)	1
Halberstadt (Germany)	הלברשטט (גרמניה)	13
Halhul (Israel)	חלחול (ישראל)	1
Halifax (N.S.)	הליפקס (נובה סקוטיה)	1
Halle an der Saale (Germany)	האלה על נהר זאלה (גרמניה)	3
Halmeu (Romania)	הלמין (רומניה)	1
Haltern in Westfalen (Germany)	הלטרן (גרמניה)	1
Halych (Ukraine)	האליץ (אוקראינה)	1
Hama'pil (Israel)	המעפיל (ישראל)	1
Hamadān (Iran)	המדאן (איראן)	2
Hamburg	המבורג	20
Hamburg (Germany)	המבורג (גרמניה)	36
Hameln (Germany)	המלין (גרמניה)	1
Hamilton (Ohio)	המילטון (אוהיו)	1
Hampshire (England)	המפשייר (אנגליה)	1
Hampstead (London, England)	המפסטד (לונדון, אנגליה)	3
Hanau (Germany)	הנאו (גרמניה)	5
Hanita (Israel)	חניתה (ישראל)	2
Hankou (Wuhan, China)	האנקו (ווהאן, סין)	1
Hannover (Germany)	הנובר (גרמניה)	7
Haradok (Belarus)	האראדוק (בלארוס)	10
Haradzets (Kobrynski rai︠o︡n, Belarus)	הורודץ (מחוז קוברין, בלארוס)	1
Harbin (China)	חרבין (סין)	3
Harlem (New York, N.Y.)	הרלם (ניו יורק, נ.י.)	1
Harrisonburg (Va.)	הריסונבורג (וירג'יניה)	1
Harrow (London, England)	הארו (לונדון, אנגליה)	1
Hartford (Conn.)	הרטפורד (קונטיקט)	5
Hartuv (Israel)	הרטוב (ישראל)	1
Hatserim (Israel)	חצרים (ישראל)	2
Hatseva (Israel)	חצבה (ישראל)	1
Hatsor Ashdod (Israel)	חצור-אשדוד (ישראל)	2
Havana (Cuba)	הוואנה (קובה)	5
Ḥawmat al-Sūq (Tunisia)	ג'רבה (תוניסיה)	57
Haysyn (Ukraine)	הייסין (אוקראינה)	4
Hazore'a (Israel)	הזורע (ישראל)	4
Hebron (West Bank)	חברון (גדה מערבית)	17
Heerlen (Netherlands)	הירלן (הולנד)	2
Hefer Valley (Israel)	עמק חפר (ישראל)	1
Heftsi-Va (Israel)	חפצי-בה (ישראל)	3
Heidelberg (Germany)	היידלברג (גרמניה)	4
Heidingsfeld (Germany)	היידינגספעלדט (גרמניה)	1
Heilbronn (Germany)	היילברון (גרמניה)	1
Hejőcsaba (Miskolc, Hungary)	טשאבא (מישקולץ, הונגריה)	1
Helsinki (Finland)	הלסינקי (פינלנד)	6
Hērakleion (Greece)	הרקליון (יוון)	1
Herat (Afghanistan)	הראת (אפגניסטן)	6
Hereford (England)	הרפורד (אנגליה)	1
Hertfordshire (England)	הרטפורדשייר (אנגליה)	2
Hert︠s︡a (Ukraine)	הרצה (אוקראינה)	1
Herzeliyya (Israel)	הרצליה (ישראל)	15
Hidalgo del Parral (Mexico)	הידאלגו דל פאראל (מקסיקו)	1
Hierapolis (Turkey : Extinct city)	היראפוליס (טורקיה : עיר קדומה)	1
Highland Park (Ill.)	היילנד פארק (אילינוי)	1
Hilversum (Netherlands)	הילברסום (הולנד)	1
Hîrlău (Romania)	הרלוי (רומניה)	3
Hlukhiv (Ukraine)	חלוחיב (אוקראינה)	3
Hlusk (Belarus)	גלוסק (בלארוס)	3
Hlybokaye (Belarus)	גלובוקי (בלארוס)	3
Hlyni︠a︡ny (Ukraine)	גליניאני (אוקראינה)	6
Hoboken (N.J.)	הובוקן (ניו ג'רזי)	1
Hod Hasharon (Israel)	הוד השרון (ישראל)	8
Hódmezővásárhely (Hungary)	הודמזושרהי (הונגריה)	1
Hodonin, Goding	גודינג (צ'כיה)	1
Hogla (Israel)	חוגלה (ישראל)	1
Hőgyész (Hungary)	הוג'ס (הונגריה)	1
Hohenzollern (Germany)	הוהנצולרן (גרמניה)	1
Holešov (Czech Republic)	הולשאו (צ'כיה)	5
Holland (Mich.)	הולנד (מישיגן)	1
Hollywood (Los Angeles, Calif.)	הוליווד (לוס אנג'לס, קליפורניה)	1
Holon (Israel)	חולון (ישראל)	22
Holoskiv (Ivano-Frankivsʹka oblastʹ, Ukraine)	הולוסקיב (מחוז איוונו-פרנקיבסק, אוקראינה)	2
Holyoke (Mass.)	הוליוק (מסצ'וסטס)	1
Holzminden (Germany)	הולצמינדן (גרמניה)	1
Homelʹ (Belarus)	הומל (בלארוס)	11
Honfleur (France)	הונפלר (צרפת)	1
Hong Kong	הונג קונג	3
Hong Kong (China)	הונג קונג (סין)	1
Honolulu (Hawaii)	הונולולו (הוואי)	4
Hoorn (Netherlands)	הורן (הולנד)	1
Hopkinsville (Ky.)	הופקינסוויל (קנטקי)	1
Horb am Neckar (Germany)	הורב אם נקאר (גרמניה)	1
Horki (Mahiliouskaia voblasts, Belarus)	הורקי (מחוז מוהילב, בלארוס)	2
Hornostaipil (Ukraine)	הורנוסטפיל (אוקראינה)	2
Horodenka (Ukraine)	הורודנקה (אוקראינה)	9
Horodło (Poland)	הורודלה (פולין)	1
Horodok (Lʹvivsʹka oblastʹ, Ukraine)	הורודוק (מחוז לביב, אוקראינה)	5
Horodok (Lut︠s︡ʹkyĭ raĭon, Ukraine)	האראדישטש (אוקראינה)	4
Hot Springs (Ark.)	הוט ספרינגס (אריזונה)	1
Houston (Tex.)	יוסטון (טקסס)	5
Höxter (Germany)	הוקסטר (גרמניה)	1
Hradec Králové (Czech Republic)	הראדץ קרלובה (צ'כיה)	1
Hranice (Olomoucky kraj, Czech Republic)	הרניצה (צ'כיה)	2
Hrodna (Belarus)	גרודנו (בלארוס)	69
Hrubieszów (Poland)	הרובישוב (פולין)	5
Hukok (Israel)	חוקוק (ישראל)	1
Hulata (Israel)	חולתה (ישראל)	1
Hulda (Israel)	חולדה (ישראל)	5
Hull (England)	האל (אנגליה)	1
Hunan Sheng (China)	הונאן שנג (סין)	1
Huncovce (Slovakia)	אונסדורף (סלובקיה)	5
Hungary	הונגריה	116
Huntingdon	הנטינגדון (אנגליה)	1
Hurfaish (Israel)	חורפיש (ישראל)	1
Husi︠a︡tyn (Ukraine)	הוסיטין (אוקראינה)	5
Hussaków (Ukraine)	הוסאקוב (אוקראינה)	1
Hutchinson (Kan.)	האצ'ינסון (קנזס)	1
Huy (Belgium)	הוי (בלגיה)	1
Hyde Park (Dutchess County, N.Y.)	הייד פארק (מחוז דאצ'ס, ניו יורק)	1
Hyderabad (India)	היידראבאד (הודו)	1
I︠A︡lta (Ukraine)	ילטה (אוקראינה)	1
I︠a︡mbol (Bulgaria)	יאמבול (בולגריה)	1
I︠A︡mpilʹ (Khmelʹnyt︠s︡ʹka oblastʹ, Ukraine)	ימפול (אוקראינה)	1
I︠A︡roslavlʹ (I︠A︡roslavskai︠a︡ oblastʹ, Russia)	ירוסלבל (מחוז ירוסלבל, רוסיה)	1
Iași (Romania)	יאסי (רומניה)	31
Iceland	איסלנד	2
Idaho	איידהו	1
Igualada (Spain)	איגואלדה (ספרד)	1
Iksal (Israel)	איכסל (ישראל)	1
Ilaniyya (Israel)	אילנייה (ישראל)	2
Ilford (London, England)	אילפורד (לונדון, אנגליה)	1
Illinois	אילינוי	5
Ilūkste (Latvia)	אילוקסטה (לטביה)	1
Iłża (Poland)	אילז'ה (פולין)	3
Immanu'el (West Bank)	עמנואל (גדה מערבית)	1
Imphāl (India)	אימפאל (הודו)	1
Independence (Mo.)	עצמאות (מיזורי)	1
India	הודו	14
Indiana	אינדיאנה	6
Indianapolis (Ind.)	אינדיאנפוליס (אינדיאנה)	1
Indonesia	אינדונזיה	1
Indura (Belarus)	אמדור (בלארוס)	8
Inowrocław (Poland)	אינוברוצלאב (פולין)	4
Insterburg (Germany)	אינסטרבורג (גרמניה)	1
Iōannina (Greece)	ינינה (יוון)	3
Iody (Belarus)	יוד (בלארוס)	1
Iowa	איווה	3
Iowa City (Iowa)	איווה סיטי (איווה)	1
Iran	איראן	28
Iraq	עיראק	48
Irbīl (Iraq)	ארביל (עיראק)	1
Ireland	אירלנד	9
Irkutsk (Russia)	אירקוטסק (רוסיה)	4
Iṣfahān (Iran)	איספהאן (איראן)	2
Isle of Man	אי מאן	1
Isle of Wight (England)	האי וייט (אנגליה)	1
Israel	ישראל	967
Istanbul (Turkey)	איסטנבול (תורכיה)	64
Italy	איטליה	52
Iŭe (Belarus)	איויה (בלארוס)	6
Ivanava (Belarus)	איונבה (בלארוס)	1
Ivangorod	דמבלין (פולין)	2
Ivanivka (Terebovli︠a︡nsʹkyĭ raĭon, Ukraine)	איווניבקה (מחוז טרנופול, אוקראינה)	1
Ivano-Frankivsʹk (Ukraine)	איוונו-פרנקיבסק (אוקראינה)	18
Ivi︠a︡nets (Belarus)	איוונץ (בלארוס)	2
Ivrea (Italy)	איבראה (איטליה)	2
Izi︠a︡slav (Ukraine)	איזיאסלב (אוקראינה)	3
İzmir (Turkey)	אזמיר (תורכיה)	57
Jackson (Miss.)	ג'קסון (מיסיסיפי)	1
Jaffa (Tel Aviv-Yafo, Israel)	יפו (תל אביב-יפו, ישראל)	63
Jagielnica (Ukraine)	יאגיילניצה (אוקראינה)	2
Jalisco (Mexico)	חליסקו (מקסיקו)	1
Janov	ינובה (ליטא)	1
Janów Lubelski (Poland)	יאנוב (פולין)	1
Japan	יפן	112
Jarbah Island (Tunisia)	ג'רבה (תוניסיה : אי)	2
Jarocin (Kalisz, Poland)	יאראטשין (פולין)	1
Jarosław (Poland)	ירוסלב (פולין)	10
Jasionówka (Poland)	יאשינובקה (פולין)	2
Jasło (Poland)	יסלו (פולין)	3
Jasper	ג'ספר (פלורידה)	1
Jaworów (województwo dolnośląskie : Poland)	יאברוב (גליציה : פולין)	3
Jaworzno (Kraków, Poland)	יבורז'נו (קרקוב, פולין)	1
Jedwabne (Poland)	ידובנה (פולין)	3
Jēkabpils (Latvia)	יקבפילס (לטביה)	7
Jelgava (Latvia)	ילגבה (לטביה)	7
Jersey	גרזי (אי)	1
Jersey City (N.J.)	ג'רזי סיטי (ניו ג'רזי)	1
Jerusalem (Israel)	ירושלים (ישראל)	938
Jesi (Italy)	יסי (איטליה)	1
Jever (Germany)	יבר (גרמניה)	1
Jevíčko (Czech Republic)	גיביץ (צ'כיה)	1
Jieznas (Lithuania)	יעזנה (ליטא)	2
Jihlava (Czech Republic)	ילאבה (צ'כיה)	1
Jilin Sheng (China)	מחוז ג'ילין (סין)	1
Jiujiang (Jiangxi Sheng, China)	ג'יוג'יאנג (מחוז ג'יאנגשי, סין)	1
Johannesburg (South Africa)	יוהנסבורג (דרום אפריקה)	18
Joigny (France)	ז'ואני (צרפת)	1
Jonava (Lithuania)	ינובה (ליטא)	7
Joniškis (Lithuania)	יונישקיס (ליטא)	3
Józefów (Poland)	יוזפוף (פולין)	1
Jurbarkas (Lithuania)	יורבורג (ליטא)	1
Jutland (Denmark)	יוטלנד (דנמרק)	1
Kābol (Afghanistan)	קאבול (אפגניסטן)	2
Kabri (Israel)	כברי (ישראל)	3
Kafr Kara (Israel)	כפר קרע (ישראל)	1
Kaliningrad	קלינינגרד (מחוז קלינינגרד, רוסיה)	4
Kaliningrad (Kaliningradskaia oblast, Russia)	קלינינגרד (מחוז קלינינגרד, רוסיה)	12
Kalinkavychy (Belarus)	קלינקביץ (בלארוס)	4
Kalisz (Poland)	קליש (פולין)	23
Kalush (Ukraine)	קלוש (אוקראינה)	12
Kałuszyn (Warsaw, Poland)	קאלושין (ורשה, פולין)	6
Kalvarija (Lithuania)	קלווריה (ליטא)	17
Kam'i︠a︡net︠s︡ʹ-Podilʹsʹkyĭ (Ukraine)	קמיניץ-פודולסק (אוקראינה)	18
Kam'i︠a︡nka Buzʹka (Ukraine)	קמיאנקה-בוזקה (אוקראינה)	2
Kamajai (Lithuania)	קאמאי (ליטא)	2
Kamakura-shi (Japan)	קמקורה (יפן)	1
Kamen (Belarus)	קאמען (בלארוס)	1
Kamen (Germany)	קמן (גרמניה)	1
Kami︠a︡nets (Brėstskai︠a︡ voblastsʹ, Belarus)	קמניץ (מחוז בריסק, בלארוס)	7
Kanczuga (Poland)	קאנצ'וגה (פולין)	1
Kansas	קנזס	2
Kansas City	קנזס סיטי (קנזס)	1
Kansas City (Mo.)	קנזס סיטי (מיזורי)	4
Kapreshty (Moldova)	קפרשט (מולדובה)	1
Kapyl (Belarus)	קפוליה (בלארוס)	10
Karkūk (Iraq)	כרכוך (עיראק)	1
Karkur (Israel)	כרכור (ישראל)	1
Karlin (Belarus)	קרלין (בלארוס)	5
Karlovy Vary (Czech Republic)	קרלובי ורי (צ'כיה)	1
Karlsruhe (Germany)	קרלסרוהה (גרמניה)	1
Karmi'el (Israel)	כרמיאל (ישראל)	4
Karne Shomron (West Bank)	קרני שומרון (גדה מערבית)	1
Karnobat (Bulgaria)	קרנובט (בולגריה)	2
Kāshān (Iran)	קאשן (איראן)	2
Kassel (Germany)	קאסל (גרמניה)	3
Kastoria (Greece)	קשטוריה (יוון)	1
Katowice (Poland)	קטוביץ (פולין)	7
Kaunas (Lithuania)	קובנה (ליטא)	92
Kavarskas (Lithuania)	קוברסק (ליטא)	1
Kazakhstan	קזחסטן	6
Kazanʹ (Russia)	קאזאן (רוסיה)	4
Kazanlŭk (Bulgaria)	קזנלוק (בולגריה)	2
Kaz︠h︡an-Haradok (Belarus)	קוז'נגורודוק (בלארוס)	1
Kazimierz (Puławy, Poland)	קוזמיר (ליד לובלין, פולין)	3
Kecskemét (Hungary)	קצ'קמט (הונגריה)	1
Kėdainiai (Lithuania)	קדאייני (ליטא)	11
Kefar Bilu (Israel)	"כפר ביל""ו (ישראל)"	2
Kefar Blum (Israel)	כפר בלום (ישראל)	1
Kefar Gil'adi (Israel)	כפר גלעדי (ישראל)	5
Kefar Hahoresh (Israel)	כפר החורש (ישראל)	1
Kefar Haro'e (Israel)	"כפר הרא""ה (ישראל)"	1
Kefar Hasidim (Israel)	כפר חסידים (ישראל)	2
Kefar Hess (Israel)	כפר הס (ישראל)	2
Kefar Mallal (Israel)	"כפר מל""ל (ישראל)"	2
Kefar Masaryk (Israel)	כפר מסריק (ישראל)	3
Kefar Pines (Israel)	כפר פינס (ישראל)	1
Kefar Rupin (Israel)	כפר רופין (ישראל)	2
Kefar Sava (Israel)	כפר סבא (ישראל)	27
Kefar Sirkin (Israel)	כפר סירקין (ישראל)	2
Kefar Szold (Israel)	כפר סולד (ישראל)	4
Kefar Tavor (Israel)	כפר תבור (ישראל)	1
Kefar Veradim (Israel)	כפר ורדים (ישראל)	1
Kefar Vitkin (Israel)	כפר ויתקין (ישראל)	2
Kefar Yehezkel (Israel)	כפר יחזקאל (ישראל)	1
Kefar Yehoshu'a (Israel)	כפר יהושוע (ישראל)	4
Keighley (England)	קיילי (אנגליה)	1
Kelme (Lithuania)	קלם (ליטא)	19
Kempen	קפנו (פולין)	2
Kendal (England)	קנדל (אנגליה)	1
Kent (England)	קנט (אנגליה)	2
Kentucky	קנטקי	2
Kerem Maharal (Israel)	"כרם מהר""ל (ישראל)"	1
Kerkyra (Greece)	קורפו (יוון : עיר)	3
Kermanshah (Iran)	כרמאנשאה (איראן)	4
Kevutsat Yavne (Israel)	קבוצת יבנה (ישראל)	4
Kežmarok (Slovakia)	קז'מרוק (סלובקיה)	3
Khabarovsk (Russia)	חברובסק (רוסיה)	1
Khanate of Bukhara	בוכרה (אמירות)	1
Kharkiv (Ukraine)	חרקוב (אוקראינה)	18
Kherson (Ukraine)	חרסון (אוקראינה)	13
Khislavichi (Russia)	חסלאוויטש (רוסיה)	2
Khodorkiv (Zhytomyr oblast, Ukraine)	חודרוקוב (מחוז ז'יטומיר, אוקראינה)	3
Khorostkiv (Ukraine)	חראשקוב (אוקראינה)	2
Khotyn (Ukraine)	חוטין (אוקראינה)	9
Khurramshahr (Iran)	קראמשהר (איראן)	1
Khust (Ukraine)	חוסט (אוקראינה)	9
Khyriv (Ukraine)	חירוב (אוקראינה)	2
Kiel (Germany)	קיל (גרמניה)	4
Kielce (Poland)	(קילץ (פולין	5
Kiev (Ukraine)	קייב (אוקראינה)	64
Kikół (Poland)	קיקול (פולין)	1
Kilii︠a︡ (Ukraine)	קילייה (אוקראינה)	1
Kingston (Jamaica)	קינגסטון (ג'מיקה)	1
Kingston upon Thames (London, England)	קינגסטון שעל התמזה (לונדון, אנגליה)	1
Kinneret (Kevutsa) (Israel)	כינרת (קבוצה) (ישראל)	6
Kirchhain, Germany	קירכהיין (הסן, גרמניה)	1
Kirman (Iran)	קרמן (איראן)	1
Kirov (Kirovskaia oblast, Russia)	קירוב (מחוז קירוב, רוסיה)	3
Kirovgrad (Russia)	קירובגרד (רוסיה)	2
Kirovohrad (Ukraine)	קירובגרד (אוקראינה)	4
Kiryas Joel (N.Y.)	קרית יואל (ניו יורק)	1
Kiryat Anavim (Israel)	קרית ענבים (ישראל)	5
Kiryat Arba (West Bank)	קרית ארבע (גדה מערבית)	1
Kiryat Ata (Israel)	קרית אתא (ישראל)	2
Kiryat Bialik (Israel)	קרית ביאליק (ישראל)	7
Kiryat Ekron (Israel)	קרית עקרון (ישראל)	1
Kiryat Gat (Israel)	קרית גת (ישראל)	1
Kiryat Hayyim (Haifa, Israel)	קרית חיים (חיפה, ישראל)	11
Kiryat Motzkin (Israel)	קרית מוצקין (ישראל)	5
Kiryat Ono (Israel)	קרית אונו (ישראל)	1
Kiryat Shemona (Israel)	קרית שמונה (ישראל)	4
Kiryat Shemuel (Israel)	קריית שמואל (ישראל)	1
Kiryat Tivon (Israel)	קרית טבעון (ישראל)	9
Kiryat Yam (Israel)	קרית ים (ישראל)	1
Kiskőrös (Hungary)	קישקורוש (הונגריה)	2
Kisvárda (Hungary)	קישורדא (הונגריה)	4
Kitchener (Ont.)	קיצ'נר (אונטריו)	1
Kittsee (Austria)	קיטזה (אוסטריה)	1
Ki︠u︡stendil (Bulgaria)	קיוסטנדיל (בולגריה)	1
Kırklareli (Turkey)	קירקלרלי (טורקיה)	1
Klagenfurt (Austria)	קלגנפורט (אוסטריה)	1
Klaipėda (Lithuania)	קלייפדה (ליטא)	3
Klatovy (Czech Republic)	קלאטובי (צ'כיה)	2
Kleck (Poland)	קלצק (פולין)	1
Klecko (Poland)	קלקו (פולין)	1
Kleczew (Poland)	קלצף (פולין)	1
Kletsk (Belarus)	קלצק (בלארוס)	14
Klevan (Ukraine)	קלוון (אוקראינה)	3
Klimontów (Poland)	קלימונטוב (פולין)	2
Kōbe-shi (Japan)	קובה-שי (יפן)	3
Koblenz (Germany)	קובלנץ (גרמניה)	1
Kobryn (Belarus)	קוברין (בלארוס)	18
Kobylin (Poland)	קובלין (פולין)	2
Kock (Poland)	קוצק (פולין)	5
Kodeń (Poland)	קודן (פולין)	2
Kojetín (Czech Republic)	קויטין (צ'כיה)	3
Kokand (Uzbekistan)	קוקנד (אוזבקיסטן)	2
Kołbiel (Poland)	קולוביאל (פולין)	1
Kolbuszowa (Poland)	קולבושובה (פולין)	4
Kolín (Czech Republic)	קולין (צ'כיה)	8
Kolky (Volynsʹka oblastʹ, Ukraine)	קולק (מחוז ווהלין, אוקראינה)	2
Kolno (Łomża, Poland)	קולנה (לומז'ה, פולין)	12
Koło (Konin, Poland)	קולו (קונין, פולין)	8
Kolomyi︠a︡ (Ukraine)	קולומיה (אוקראינה)	18
Komarno (Ukraine)	קומרנה (אוקראינה)	11
Komárom (Hungary)	קומרום (הונגריה)	1
Komarów (Poland)	קומרוב (פולין)	2
Kömlőd (Hungary)	קומלוד (הונגריה)	1
Konin (Konin, Poland)	קונין (קונין, פולין)	1
Konotop (Sumsʹka oblastʹ, Ukraine)	קונוטופ (מחוז סומי, אוקראינה)	9
Konotop, Ukraine	קונוטופ (מחוז סומי, אוקראינה)	1
Końskie (Województwo Świętokrzyskie, Poland)	קונסקי (פולין)	1
Końskowola (Poland)	קונסקה וולה (פולין)	4
Kopychynt︠s︡i (Ukraine)	קופיצ'ניץ (אוקראינה)	5
Kopys (Belarus)	קופוסט (בלארוס)	1
Korazim (Israel)	כורזים (ישראל)	1
Korbach (Germany)	קורבך (גרמניה)	1
Korea	קוריאה	1
Korelichi (Belarus)	קורליץ (בלארוס)	3
Koret︠s︡ʹ (Ukraine)	קוריץ (אוקראינה)	5
Kórnik (Poland)	קורניק (פולין)	1
Kos (Greece)	קוס (יוון)	1
Košice (Slovakia)	קושיצה (סלובקיה)	8
Kosiv (Ukraine)	קוסוב (אוקראינה)	11
Kosovo (Serbia)	קוסובו (סרביה)	2
Kosów Lacki (Poland)	קוסוב (פולין)	1
Kostobobriv (Ukraine)	קוסטובובר (אוקראינה)	1
Koszyce (Województwo Małopolskie, Poland)	קושיץ (פולין קטן)	2
Köthen (Germany)	קתן (גרמניה)	1
Kovachevt︠s︡i (Bulgaria)	קובצ'בצי (בולגריה)	1
Kovelʹ (Ukraine)	קובל (אוקראינה)	2
Kowel	קובל (אוקראינה)	4
Kozienice (Poland)	קוז'ניץ (פולין)	3
Kozin (Ukraine)	קוזין (אוקראינה)	2
Kozlany (Czech Republic)	קוזלני (צ'כיה)	1
Kozlovshchina (Belarus)	קוזלושצינא (בלארוס)	1
Kozminek (Wojewodztwo wielkopolskie, Poland)	קוז'מינק (מחוז פולין גדול, פולין)	1
Krakės (Lithuania)	קראק (ליטא)	1
Krakow (Poland)	קרקוב (פולין)	122
Krāslava (Latvia)	קרסלבה (לטביה)	1
Krasne (Odesʹka oblastʹ, Ukraine)	קרסנה (מחוז אודסק, אוקראינה)	1
Krasne (Ukraine)	קרסנה (אוקראינה)	1
Kraśnik (Poland)	קרשניק (פולין)	3
Krasnobród (Poland)	קרסנוברוד (פולין)	1
Krasnystaw (Poland)	קרסניסטב (פולין)	2
Krasyliv (Ukraine)	קרסילוב (אוקראינה)	1
Kražiai (Lithuania)	קרז (ליטא)	3
Krefeld (Germany)	קרפלד (גרמניה)	2
Krekenava (Lithuania)	קרקינובה (ליטא)	6
Kremenchuk (Poltavsʹka oblastʹ, Ukraine)	קרמנצ'וג (מחוז פולטבה, אוקראינה)	2
Kremenchuk (Ukraine)	קרמנצ'וג (אוקראינה)	13
Kremenets (Ukraine)	קרמניץ (אוקראינה)	12
Kretinga (Lithuania)	קרטינגה (ליטא)	4
Kreuzburg (Germany)	קרויצבורג (גרמניה)	2
Krolevet︠s︡ʹ (Ukraine)	קרולבץ (אוקראינה)	1
Krotoszyn (Kalisz, Poland)	קרוטושין (קליש, פולין)	7
Krychaŭ (Belarus)	קריצ'או (בלארוס)	3
Krynki (Poland)	קרינקי (פולין)	9
Kryve Ozero (Ukraine)	קריבויה אוזרו (אוקראינה)	4
Kryvyĭ Rih (Ukraine)	קריבי ריה (אוקראינה)	2
Kryzhopil (Ukraine)	קריז'ופיל (אוקראינה)	1
Krzemieniec (Poland)	קרמניץ (פולין)	4
Krzepice (Poland)	קשפיץ (פולין)	2
Książ Wielki (Poland)	קשוינז' (פולין)	1
Kudirkos Naumiestis (Lithuania)	קודירקוס נאומייסטיס (ליטא)	4
Kudryntsi (Ukraine)	קודרוניץ (אוקראינה)	1
Kukeziv (Ukraine)	קוקזיב (אוקראינה)	2
Kuldīga (Latvia)	קולדיגה (לטביה)	1
Kunszentmárton (Hungary)	קונסנטמרטון (הונגריה)	1
Kurdistan	כורדיסטאן	4
Kurenet︠s︡ (Belarus)	קורניץ (בלארוס)	2
Kurima (Slovakia)	קורימה (סלובקיה)	1
Kurów (Lublin, Poland)	קורוב (פולין)	2
Kuršėnai (Lithuania)	קורשנאי (ליטא)	3
Kursk (Russia)	קורסק (רוסיה)	1
Kurzeniec, Kurenets	קורניץ (בלארוס)	1
Kutaisi (Georgia)	קוטאיסי (גאורגיה)	2
Kutná Hora (Czech Republic)	קוטנה הורה (צ'כיה)	1
Kutno (Poland)	קוטנו (פולין)	14
Kuty (Ukraine)	קוטוב (אוקראינה)	7
Kutztown (Pa.)	קוצטאון (פנסילבניה)	1
Kuźnica (Poland)	קוז'ניצה (פולין)	1
Kybartai (Lithuania)	קיברט (ליטא)	1
Kyjov (Jihomoravský kraj, Czech Republic)	קיוב (צ'כיה)	1
Kyoto (Japan)	קיוטו (יפן)	2
Kytaĭhorod (Trosti︠a︡net︠s︡ʹkyĭ raĭon, Vinnyt︠s︡ʹka oblastʹ, Ukraine)	קייטייהורוד (מחוז טרוסטיאנץ, אוקראינה)	1
Lʹviv (Ukraine)	לבוב (אוקראינה)	136
La Chaux-de-Fonds (Switzerland)	לה-שו-דה-פון (שווייץ)	1
La Crosse (Wis.)	לה קרוס (ויסקונסין)	2
La Paz (Bolivia)	לה פאס (בוליביה)	1
La Rochelle (France)	לה רושל (צרפת)	1
La Spezia (Italy)	לה ספציה (איטליה)	1
Łabiszyn (Poland)	לבשין (פולין)	1
Lackenbach (Austria)	לקנבך (אוסטריה)	2
Łagów (Zielona Góra, Poland)	לאגוב (זיילונה גורה, פולין)	1
Lahavot Habashan (Israel)	להבות הבשן (ישראל)	1
Lahishyn (Belarus)	לאהישין (בלארוס)	2
Lahoysk (Belarus)	לאהיסק (בלארוס)	2
Lakewood (N.J.)	לייקווד (ניו ג'רזי)	7
Lakhva (Belarus)	לחוה (בלארוס)	2
Lancashire (England)	לנקשייר (אנגליה)	1
Lancaster (England)	לנקסטר (אנגליה)	1
Łańcut (Poland)	לנצוט (פולין)	2
Langres (France)	לאנגר (צרפת)	1
Languedoc (France)	לנגדוק (צרפת)	1
Lanivt︠s︡i (Lanovet︠s︡ʹkyĭ raĭon, Ukraine)	לאניבצי (מחוז לאניביצקי, אוקראינה)	3
Laramie (Wyo.)	לאראמי (ויומינג)	1
Larisa (Greece)	לריסה (יוון)	2
Larnaca (Cyprus)	לרנקה (קפריסין)	1
Larvik (Norway)	לרביק (נורבגיה)	1
Las Palmas (Canary Islands)	לאס פאלמאס (האיים הקנריים)	1
Las Vegas (Nev.)	לאס וגאס (נבדה)	2
Lask (Poland)	לאסק (פולין)	11
Laszczow (Poland)	לשצ'וב (פולין)	2
Latvia	לטביה	20
Lausanne (Switzerland)	לוזאן (שווייץ)	1
Lawrence (Mass.)	לורנס (מסצ'וסטס)	2
Lazdijai (Lithuania)	לזדיי (ליטא)	3
Le Havre (France)	לה אבר (צרפת)	2
Lebanon	לבנון	4
Lebedyn (Ukraine)	לבדין (אוקראינה)	1
Łęczyca (Poland)	לונטשיץ (פולין)	8
Leeds (England)	לידס (אנגליה)	5
Leerdam (Netherlands)	לרדם (הולנד)	1
Leeuwarden (Netherlands)	ליאווארדן (הולנד)	4
Leicester (England)	לסטר (אנגליה)	3
Leiden (Netherlands)	ליידן (הולנד)	3
Leigh	ליי (לנקשייר, אנגליה)	1
Leipzig (Germany)	ליפציג (גרמניה)	24
Lelów (Poland)	ללוב (פולין)	1
Lemberg (Austria)	למברג (אוסטריה)	1
Lemešany (Slovakia)	לעמעש (סלובקיה)	1
Lemgo (Germany)	למגו (גרמניה)	1
Lendava (Slovenia)	לנדבה (סלובניה)	1
Lenin (Z︠H︡ytkavitski rai︠o︡n, Belarus)	לנין (בלארוס)	1
Leningrad (R.S.F.S.R.)	לנינגראד (רוסיה)	9
Leominster (Mass.)	למנסטר (מסצ'וסטס)	2
León (Spain)	ליאון (ספרד)	1
Lepelʹ (Belarus)	לפל (בלארוס)	5
Lesko (Poland)	לסקו (פולין)	9
Leszno (Poland)	לשנו (פולין)	10
Letchworth (England)	לצ'וורת' (אנגליה)	1
Letychiv (Ukraine)	לטיצ'ב (אוקראינה)	2
Leutershausen (Germany)	לייטרשהוזן (גרמניה)	1
Leżajsk (Poland)	ליז'נסק (פולין)	3
Libava, Liepaja	ליפאיה (לטביה)	1
Liberec (Czech Republic)	ליברץ (צ'כיה)	1
Liberty (N.Y.)	ליברטי (ניו יורק)	1
Libya	לוב	3
Lida (Belarus)	לידה (בלארוס)	11
Lidingö (Sweden)	לידינגה (שבדיה)	1
Liège (Belgium)	ליאז' (בלגיה)	3
Liepāja (Latvia)	ליפאיה (לטביה)	10
Lier (Belgium)	לייר (בלגיה)	1
Lille (France)	ליל (צרפת)	2
Lima (Peru)	לימה (פרו)	3
Limanowa (Poland)	לימינוב (פולין)	5
Limoges (France)	לימוז' (צרפת)	2
Lincoln (Neb.)	לינקולן (נברסקה)	3
Lincolnshire	לינקולנשייר (אנגליה)	1
Lindow (Neuruppin, Germany)	לינדו (ניורופין, גרמניה)	1
Linkuva (Lithuania)	לונקובה (ליטא)	7
Lipkany (Moldavian S.S.R.)	ליפקני (מולדובה)	6
Lipník nad Bečvou (Czech Republic)	ליפניק (צ'כיה)	6
Lipnishki (Belarus)	ליפנישאק (בלארוס)	4
Lipnishki, Belarus	ליפנישאק (בלארוס)	1
Lipno (Włocławek, Poland)	ליפנו (ולוצלאווק, פולין)	6
Lippe (Germany)	ליפה (גרמניה)	1
Lippstadt (Germany)	ליפשטט (גרמניה)	1
Liptovský Mikuláš (Slovakia)	ליפטובסקי מיקולש (סלובקיה)	2
Lisbon (Portugal)	ליסבון (פורטוגל)	11
Lithuania	ליטא	62
Litomyšl (Czech Republic)	ליטומישל (צ'כיה)	1
Little Rock (Ark.)	ליטל רוק (ארקנסו)	1
Li︠u︡bavichi (Russia)	ליובויץ' (רוסיה)	13
Li︠u︡bomlʹ (Ukraine)	לובומל (אוקראינה)	1
Liverpool (England)	ליורפול (אנגליה)	14
Livonia	ליבוניה	1
Livorno (Italy)	ליוורנו (איטליה)	23
Llandaff (Wales)	לאנדאף (ויילס)	1
Łobżenica (Poland)	לובזניצ'ה (פולין)	1
Lod (Israel)	לוד (ישראל)	3
Łódź (Poland)	לודז' (פולין)	158
Lohame Hageta'ot (Israel)	לוחמי הגטאות (ישראל)	3
Loire-Atlantique (France)	לואר-אטלנטי (צרפת)	1
Lom (Bulgaria)	לום (בולגריה)	1
Łomazy (Poland)	לומז (פולין)	6
Lombardy (Italy)	לומברדיה (איטליה)	1
Łomża (Poland)	לומזה (פולין)	20
London (England)	לונדון (אנגליה)	234
London (Ont.)	לונדון (אונטריו)	1
Long Beach (Calif.)	לונג ביץ' (קליפורניה)	1
Long Island (N.Y.)	לונג איילנד (ניו יורק)	3
Long Island, U.S.A.	לונג איילנד (ניו יורק)	1
Lopatyn (Ukraine)	לופטין (אוקראינה)	1
Lorient (France)	לוריין (צרפת)	1
Los Angeles (Calif.)	לוס אנג'לס (קליפורניה)	21
Łosice (Poland)	לושיץ (פולין)	2
Louisiana	לואיזיאנה	1
Louisville (Ky.)	לואיוויל (קנטקי)	4
Louth (Ireland : County)	לאות' (אירלנד : מחוז)	1
Lovasberény (Hungary)	לובאש-ברני (הונגריה)	1
Łowicz (Poland)	לוביץ' (פולין)	6
Loyev (Belarus)	לאיאוו (בלארוס)	1
Lubaczów (Poland)	לובאצ'וב (פולין)	4
Lubartów (Poland)	לוברטוב (פולין)	2
Lübeck (Germany)	ליבק (גרמניה)	6
Lublin (Poland)	לובלין (פולין)	37
Lubraniec (Poland)	לובראנייץ (פולין)	2
Lucca (Italy)	לוקה (איטליה)	1
Lucena	לוסנה (ספרד)	1
Lucerne (Switzerland)	לוצרן (שווייץ)	2
Luckenwalde (Germany)	לוקנוולדה (גרמניה)	1
Ludhiana (India : District)	לודהיאנה (הודו : מחוז)	1
Ludwigsburg (Germany)	לודוויגסבורג (גרמניה)	1
Ludza (Latvia)	לודזה (לטביה)	4
Łuków (Siedlce, Poland)	לוקוב (פולין)	3
Lunel (France)	לוניל (צרפת)	5
Lutomiersk (Poland)	לוטומיירסק (פולין)	2
Luton (England)	לוטון (אנגליה)	1
Lut︠s︡ʹk (Ukraine)	לוצק (אוקראינה)	3
Luxembourg	לוכסמבורג	1
Luxembourg (Luxembourg)	לוכסמבורג (לוכסמבורג)	1
Lyady (Belarus)	ליאדי (בלארוס)	6
Lyakhavichy (Belarus)	לחוביץ' (בלארוס)	11
Lyck (Germany)	ליק (גרמניה)	1
Lyëzna (Belarus)	ליוזנו (בלארוס)	7
Lynchburg (Va.)	לינצ'בורג (וירג'יניה)	1
Lyon (France)	ליון (צרפת)	10
Lypovets (Ukraine)	ליפהאיץ (אוקראינה)	4
Lysi︠a︡nka (Ukraine)	ליסיאנקה (אוקראינה)	1
Lyubcha (Belarus)	לובטש (בלארוס)	3
Ma'agan Mikha'el (Israel)	מעגן מיכאל (ישראל)	1
Ma'ale Adummim (West Bank)	מעלה אדומים (גדה מערבית)	1
Ma'alot (Israel)	מעלות (ישראל)	2
Ma'barot (Israel)	מעברות (ישראל)	6
Ma'oz Hayyim (Israel)	מעוז חיים (ישראל)	4
Ma'yan Barukh (Israel)	מעיין ברוך (ישראל)	2
Ma'yan Tsevi (Israel)	מעיין צבי (ישראל)	1
Macclesfield	מקלספילד (אנגליה)	1
Mád (Hungary)	מאד (הונגריה)	2
Madrid (Spain)	מדריד (ספרד)	7
Magdeburg (Germany)	מגדהבורג (גרמניה)	12
Magdiel (Hod Hasharon, Israel)	מגדיאל (הוד השרון, ישראל)	3
Magenta (Italy)	מג'נטה (איטליה)	1
Maggal (Israel)	מגל (ישראל)	3
Magnēsia (Greece)	מגנזיה (יוון)	1
Magnitogorsk (Russia)	מגניטוגורסק (רוסיה)	1
Magocs (Hungary)	מגוץ' (הונגריה)	1
Magshimim (Israel)	מגשימים (ישראל)	1
Mahanayim (Israel)	מחניים (ישראל)	4
Maharashtra (India)	מהרשטרה (הודו)	1
Mahili︠o︡ŭ (Belarus)	מוהילב (בלארוס)	35
Maidenhead (England)	מיידנהד (אנגליה)	2
Maidstone (England)	מיידסטון (אנגליה)	2
Maine	מיין	3
Maine-et-Loire (France)	מן ולואר (צרפת)	1
Majd al-Kurum (Israel)	מג'ד אל-כרום (ישראל)	1
Majdan (Serbia)	מאידאן (סרביה)	1
Majorca (Spain)	מיורקה (ספרד)	1
Makariv (Ukraine)	מקריב (אוקראינה)	4
Makó (Hungary)	מקובה (הונגריה)	2
Makow Mazowiecki (Poland)	מקוב מזוביצק (פולין)	5
Maladzechna (Belarus)	מלדז'נה (בלארוס)	8
Málaga (Spain)	מלאגה (ספרד)	2
Malaya Berestovitsa (Belarus)	ברסטוביץ' (בלארוס)	1
Malden (Mass.)	מלדן (מסצ'וסטס)	1
Malenice (Radom, Poland)	מלניץ (פולין)	1
Malta	מלטה	1
Malvern	מלוורן (אנגליה)	1
Malyn (Rivnensʹka oblastʹ, Ukraine)	מאלין (אוקראינה)	6
Malyn, Ukraine	מאלין (אוקראינה)	1
Manākhah (Yemen)	מנאכה (תימן)	2
Manchester (England)	מנצ'סטר (אנגליה)	22
Manchester (N.H.)	מנצ'סטר (ניו המפשייר)	1
Manchuria (China)	מנצ'וריה (סין)	1
Manhattan (New York, N.Y.)	מנהטן (ניו יורק, נ.י.)	11
Manila (Philippines)	מנילה (פיליפינים)	1
Manisa (Turkey)	מניסה (טורקיה)	1
Mannheim (Germany)	מנהיים (גרמניה)	8
Manosque (France)	מנוסק (צרפת)	1
Mansfeld (Halle, Germany)	מנספלר (הלה, גרמניה)	1
Manṣūrah (Egypt)	מנצורה (מצרים)	1
Mantua (Italy)	מנטובה (איטליה)	21
Marburg (Germany)	מרבורג (גרמניה)	1
Mariiampil (Ukraine)	מארינפאל (אוקראינה)	1
Marijampolė (Lithuania)	מרימפול (ליטא)	12
Marion (Ind.)	מריון (אינדיאנה)	1
Mariupolʹ (Ukraine)	מריאופול (אוקראינה)	5
Marjayoun (Lebanon)	מרג' עיון (לבנון)	1
Marktbreit (Germany)	מרקטברייט (גרמניה)	2
Marktheidenfeld (Germany)	מרקטהיידנפלד (גרמניה)	1
Marseille (France)	מרסי (צרפת)	7
Maryland	מרילנד	3
Mashhad (Iran)	משהד (איראן)	2
Massachusetts	מסצ'וסטס	12
Massu'ot Yits'hak (Israel)	משואות יצחק (ישראל)	1
Masty (Belarus)	מאסטי (בלארוס)	1
Mattersburg (Austria)	מטרסדורף (אוסטריה)	5
Mauritius	מאוריציוס	1
Maziarnia (Chełm, Poland)	מזיאריאנה (חלם, פולין)	1
Mazkeret Batya (Israel)	מזכרת בתיה (ישראל)	1
Mazyr (Homelʹskai︠a︡ voblastsʹ, Belarus)	מוזיר (מחוז הומל, בלארוס)	2
McAllen (Tex.)	מק'אלן (טקסס)	1
Me'ir Shfeya (Israel)	מאיר שפיה (ישראל)	1
Mecca (Saudi Arabia)	מכה (ערב הסעודית)	2
Médéa (Algeria)	מדיאה (אלג'יריה)	1
Medellín (Colombia)	מדיין (קולומביה)	2
Medina Azahàra (Extinct city)	מדינה אזהרה (עיר קדומה)	1
Medinaceli (Spain)	מדינצ'לי (ספרד)	1
Medz︠h︡ybiz︠h︡ (Ukraine)	מז'יבוז' (אוקראינה)	10
Mefalsim (Israel)	מפלסים (ישראל)	2
Meiningen (Germany)	מיינינגן (גרמניה)	2
Melbourne (Vic.)	מלבורן (ויקטוריה)	14
Melnik	מלניק (בולגריה)	2
Memel (East Prussia, Germany)	ממל (פרוסיה המזרחית, גרמניה)	2
Memphis (Tenn.)	ממפיס (טנסי)	1
Menahemya (Israel)	מנחמיה (ישראל)	2
Mendoza (Argentina)	מנדוזה (ארגנטינה)	2
Merhavya (Israel)	מרחביה (ישראל)	7
Meridian (Miss.)	מרידיאן (מיסיסיפי)	1
Merkinė (Lithuania)	מרטש (ליטא)	2
Merom Hagalil (Israel)	מרום הגליל (ישראל)	1
Merseburg (Germany)	מרזהבורג (גרמניה)	1
Mersin (İçel İli, Turkey)	מרסין (מחוז איצ'ל, טורקיה)	1
Mesa (Ariz.)	מסה (אריזונה)	1
Meshar (Israel)	מישר (ישראל)	1
Mesillot (Israel)	מסילות (ישראל)	1
Metar (Israel)	מיתר (ישראל)	2
Metser (Israel)	מצר (ישראל)	1
Metula (Israel)	מטולה (ישראל)	2
Metz (France)	מץ (צרפת)	12
Meurthe-et-Moselle (France)	מרת ומוזל (צרפת)	1
Mevasseret Tsiyyon (Israel)	מבשרת ציון (ישראל)	3
Mexico	מקסיקו	22
Mexico City (Mexico)	מקסיקו סיטי (מקסיקו)	10
Mez︠h︡yrichchi︠a︡ (Ukraine)	מזריץ' (אוקראינה)	1
Mezőkövesd (Hungary)	מזוקובשד (הונגריה)	2
Mezőszilas (Hungary)	סילאש (הונגריה)	1
Miami (Fla.)	מיאמי (פלורידה)	3
Michalovce (Slovakia)	מיכלובצה (סלובקיה)	4
Michałowo (Białystok, Poland)	מיכאלובה (פולין)	1
Michelstadt (Germany)	מיכלשטט (גרמניה)	2
Michigan	מישיגן	9
Middlesex (England)	מידלסקס (אנגליה)	1
Midland (Tex.)	מידלנד (טקסס)	1
Międzychód (Gorzów Wielkopolski, Poland)	מזיחוד (פולין)	1
Międzyrzec Podlaski (Poland)	מזריץ' (פולין)	22
Mielec (Poland)	מליץ (פולין)	4
Mielnik (Poland)	מילניק (פולין)	1
Migdal (Israel)	מגדל (ישראל)	3
Mihăileni (Botoşani, Romania)	מיכאילן (בוטושן, רומניה)	5
Mikulov (Jihomoravský kraj, Czech Republic)	מיקולוב (מורביה הדרומית, צ'כיה)	14
Milan (Italy)	מילנו (איטליה)	19
Milford (Conn.)	מילפורד (קונטיקט)	1
Milton (Mass.)	מילטון (מסצ'וסטס)	1
Milwaukee (Wis.)	מילווקי (ויסקונסין)	5
Mingāora (Pakistan)	מינגאורה (פקיסטן)	1
Minneapolis (Minn.)	מיניאפוליס (מינסוטה)	1
Minnesota	מינסוטה	1
Minsk (Belarus)	מינסק (בלארוס)	89
Mińsk Mazowiecki (Poland)	מינסק מזובייצקי (פולין)	4
Mir (Belarus)	מיר (בלארוס)	22
Mirandola, Emilia-Romagna, Italy	מירנדולה (איטליה)	1
Misgav Am (Israel)	משגב עם (ישראל)	1
Mishmar Ha'emek (Israel)	משמר העמק (ישראל)	8
Mishmar Hanegev (Israel)	משמר הנגב (ישראל)	1
Mishmar Hasharon (Israel)	משמר השרון (ישראל)	2
Mishmar Hashiv'a (Israel)	משמר השבעה (ישראל)	1
Mishmarot (Israel)	משמרות (ישראל)	1
Miskolc (Hungary)	מישקולץ (הונגריה)	3
Miskovice (Czech Republic)	מיסקוביץ' (צ'כיה)	1
Mississippi	מיסיסיפי	1
Missouri	מיזורי	3
Mitchelstown (Ireland)	מיצ'לסטאון (אירלנד)	1
Mitspa (Israel)	מצפה (ישראל)	1
Mitte (Berlin, Germany)	מיטה (ברלין, גרמניה)	1
Mizoch (Ukraine)	מיזוץ' (אוקראינה)	1
Mizra (Israel)	מזרע (ישראל)	6
Mladá Boleslav (Czech Republic)	מלאדה בולסלב (צ'כיה)	6
Mława (Poland)	מלוה (פולין)	5
Mlyniv (Ukraine)	מלינוב (אוקראינה)	3
Mobile (Ala.)	מובייל (אלבמה)	1
Modena (Italy)	מודנה (איטליה)	4
Modi'in Illit (West Bank)	מודיעין עילית (גדה מערבית)	6
Mogi das Cruzes (Brazil)	מוז'י דס קרוזס (ברזיל)	1
Mogielnica	מוגלניצה (פולין)	2
Mogilno (Bydgoszcz, Poland)	מוגילנן (פולין)	1
Mohrungen (Germany)	מוהרונגן (גרמניה)	1
Mohyliv-Podilʹsʹkyĭ (Ukraine)	מויליב-פודילסקי (אוקראינה)	7
Moineşti (Romania)	מוינשט (רומניה)	2
Moisés Ville (Argentina)	מוזסטויל (ארגנטינה)	2
Moldavia	נסיכות מולדובה	1
Moldova	מולדובה	5
Moledet (Israel)	מולדת (מושב)	2
Molėtai (Lithuania)	מולטאי (ליטא)	3
Mommenheim (Germany)	מומנהיים (גרמניה)	1
Momostenango (Guatemala)	מומוסטננגו (גואטמלה)	1
Monasterzyska (Poland)	מונאסטרישץ' (פולין)	2
Monastir	מונסטיר (תוניסיה)	1
Monchen-Gladbach (Germany)	מינכן גלאדבך (גרמניה)	1
Mondovì (Italy)	מונדובי (איטליה)	1
Monmouth (Wales)	מונמות (ויילס)	1
Monroe (N.Y.)	מונרו (ניו יורק)	1
Monroeville (Ala.)	מונרוויל (אלבמה)	1
Mons (Belgium)	מונס (בלגיה)	1
Monselice (Italy)	מונסליצ'ה (איטליה)	1
Monsey (N.Y.)	מונסי (ניו יורק)	3
Montagnana (Italy)	מונטאניאנה (איטליה)	1
Montana	מונטנה	2
Montbrison (Loire, France)	מונטבריסון (לואר, צרפת)	1
Montclair (N.J.)	מונטקלר (ניו ג'רזי)	1
Montecchio	מונטקיו (איטליה)	1
Monterrey (Mexico)	מונטריי (מקסיקו)	1
Montevideo (Uruguay)	מונטווידאו (אורוגוואי)	3
Montgomery (Ala.)	מונטגומרי (אלבמה)	1
Montpellier (France)	מונפלייה (צרפת)	3
Montréal (Québec)	מונטריאול (קוויבק)	22
Montreux (Switzerland)	מונטרה (שווייץ)	1
Mór (Hungary)	מור (הונגריה)	3
Moravia (Czech Republic)	מורביה (צ'כיה)	9
Morbihan (France)	מורביאן (צרפת)	1
Morocco	מרוקו	76
Morton (Ill.)	מורטון (אילינוי)	1
Mosbach (Baden-Württemberg, Germany)	מוסבאך (גרמניה)	1
Moscow (Russia)	מוסקבה (רוסיה)	118
Mostaganem (Algeria)	מוסטאגאנם (אלג'יריה)	1
Mostysʹka (Ukraine)	מוסטיסקה (אוקראינה)	3
Motalʹ (Belarus)	מוטלה (בלארוס)	9
Motsa (Israel)	מוצא (ישראל)	1
Mstsislaŭ (Belarus)	מסטיסלאו (בלארוס)	1
Mstsislaw (Belarus)	אמסטיסלב (בלארוס)	6
Mszczonów (Poland)	אמשינוב (פולין)	2
Mühldorf am Inn (Germany)	מולדורף אם אין (גרמניה)	1
Mukacheve (Ukraine)	מונקטש (אוקראינה)	22
Mukachevo, Munkacz	מונקטש (אוקראינה)	1
Muknīn (Tunisia)	מוכנין (תוניסיה)	1
Mulhouse (France)	מולהאוס (צרפת)	2
Mumbai (India)	מומבאי (הודו)	12
Munich (Germany)	מינכן (גרמניה)	35
Murafa (Vinnyt︠s︡ʹka oblastʹ, Ukraine)	מוראפה (מחוז ויניצה, אוקראינה)	1
Murano (Italy)	מורנו (איטליה)	2
Muskogee (Okla.)	מוסקוגי (אוקלהומה)	1
Mykolaïv (Mykolaïvsʹka oblastʹ, Ukraine)	מיקולייב (מחוז מיקולייב, אוקראינה)	8
Mykolaïv (Ukraine)	מיקולייב (אוקראינה)	2
Mykulynt︠s︡i (Ukraine)	מיקולינצי (אוקראינה)	4
Mynʹkivt︠s︡i (Dunai︠e︡vet︠s︡ʹkyĭ raĭon, Ukraine)	מינקיבצי (מחוז דונאיבצי, אוקראינה)	1
Myrhorod (Poltavsʹka oblastʹ, Ukraine)	מירהורוד (מחוז פולטבה, אוקראינה)	1
Myślenice (Poland)	מישלניץ (פולין)	1
Mysłowice (Poland)	מיסלוביץ (פולין)	3
Na'an (Israel)	נען (ישראל)	2
Naarden (Netherlands)	נארדן (הולנד)	1
Nabeul (Tunisia)	נבל (תוניסיה)	2
Nablus (West Bank)	שכם (גדה מערבית)	3
Náchod (Královéhradecký kraj, Czech Republic)	נאחוד (מחוז הראדץ קראלובה, צ'כיה)	1
Nadvirna (Ukraine)	נדבורנה (אוקראינה)	8
Nagykanizsa (Hungary)	נג'קניז'ה (הונגריה)	2
Nahalal (Israel)	נהלל (ישראל)	10
Nahariyya (Israel)	נהריה (ישראל)	14
Nahshonim (Israel)	נחשונים (ישראל)	2
Nairobi (Kenya)	ניירובי (קניה)	1
Námestovo (Slovakia)	נמיסטובו (סלובקיה)	1
Nancy (France)	ננסי (צרפת)	6
Nantes (France)	נאנט (צרפת)	5
Naples (Italy)	נאפולי (איטליה)	10
Naraïv (Ukraine)	נריוב (אוקראינה)	1
Narbonne (France)	נרבון (צרפת)	6
Narewka (Poland)	נארבה (פולין)	1
Narol (Poland)	נראל (פולין)	2
Nashville (Tenn.)	נאשוויל (טנסי)	1
Nasielsk (Poland)	נאשלסק (פולין)	2
Natsrat Illit (Israel)	נצרת עילית (ישראל)	1
Navahrudak (Belarus)	נובהרדוק (בלארוס)	9
Nazareth (Israel)	נצרת (ישראל)	10
Nea Iōnia (Greece)	נאה יוניאה (יוון)	1
Nebraska	נברסקה	1
Negba (Israel)	נגבה (ישראל)	4
Negev (Israel)	נגב (ישראל)	3
Neidenburg (Germany)	נידנבורג (גרמניה)	1
Neisse (Germany)	נייסה (גרמניה)	2
Nemakščiai (Lithuania)	נמקשט (ליטא)	3
Nemyriv (Lʹvivsʹka oblastʹ, Ukraine)	נמירוב (אוקראינה)	3
Nes Tsiyyona (Israel)	נס ציונה (ישראל)	5
Nesconset (N.Y.)	נסקונסט (ניו יורק)	1
Nesterov (Kaliningradskai︠a︡ oblastʹ, Russia)	נסטרוב (מחוז קלינינגרד, רוסיה)	1
Netanya (Israel)	נתניה (ישראל)	20
Netherlands	הולנד	155
Netiv Hashayyara (Israel)	נתיב השיירה (ישראל)	1
Netivot (Israel)	נתיבות (ישראל)	2
Netu'a (Israel)	נטועה (ישראל)	1
Neuilly-sur-Seine (France)	נויי-סור-סן (צרפת)	1
Neumünster (Schleswig-Holstein, Germany)	נוימינסטר (שלזוויג-הולשטיין, גרמניה)	1
Neuruppin (Germany)	נוירופין (גרמניה)	1
Neustadt an der Weinstrasse (Germany)	נוישטדט אן דר וויינשטרסה (גרמניה)	1
Neuwied (Germany)	נויוויד (גרמניה)	1
Neve Ilan (Israel)	נווה אילן (ישראל)	1
Nevelʹ (Russia)	נבל (רוסיה)	3
New Brunswick	ניו ברונסוויק	1
New Brunswick (N.J.)	ניו ברנזוויק (ניו ג'רזי)	1
New Delhi (India)	ניו דלהי (הודו)	2
New Hampshire	ניו המפשיר	1
New Harmony	ניו הרמוניה (אינדיאנה)	1
New Haven (Conn.)	ניו הייבן (קונטיקט)	6
New Jersey	ניו ג'רזי	12
New Mexico	ניו מקסיקו	1
New Orleans (La.)	ניו אורלינס (לואיזיאנה)	8
New York (N.Y.)	ניו יורק (נ.י.)	263
New York (State)	ניו יורק (מדינה)	3
New Zealand	ניו-זילנד	3
Newark (N.J.)	ניוארק (ניו ג'רזי)	8
Newburgh	ניובורג (אינדיאנה)	1
Newbury (England)	ניוברי (אנגליה)	2
Newcastle upon Tyne (England)	ניוקאסל על נהר טיין (אנגליה)	3
Newport (Wales)	ניופורט (ויילס)	1
Newton (Mass.)	ניוטון (מסצ'וסטס)	1
Ni︠a︡sviz︠h︡ (Belarus)	נסויז' (בלארוס)	25
Nice (France)	ניס (צרפת)	8
Niemirów (Poland)	ניימירוב (פולין)	1
Nigeria	ניגריה	2
Nijmegen (Netherlands)	ניימיכן (הולנד)	2
Nikopol (Bulgaria)	ניקופול (בולגריה)	1
Nîmes (France)	נים (צרפת)	3
Nitra (Slovakia)	ניטרה (סלובקיה)	8
Nitsanim (Israel)	ניצנים (ישראל)	1
Nizhnii Novgorod (Russia)	ניז'ני נובגורוד (רוסיה)	2
Nizhniĭ Novgorod, Russia	מחוז ניז'גורוד (רוסיה)	1
Niz︠h︡yn (Ukraine)	ניזהין (אוקראינה)	3
Nordhausen (Thuringia, Germany)	נורדהאוזן (גרמניה)	1
Norfolk (Va.)	נורפולק (וירג'יניה)	1
Normandy (France)	נורמנדיה (צרפת)	1
North Carolina	קרולינה הצפונית	3
Northampton (England)	נורתמפטון (אנגליה)	2
Northampton (Mass.)	נורת'המפטון (מסצ'וסטס)	1
Northamptonshire (England)	נורת'המפטונשייר (אנגליה)	1
Northern Ireland	צפון אירלנד	1
Northumberland	נורת'מברלנד (אנגליה)	1
Norway	נורבגיה	6
Norwich (Conn.)	נורויץ' (קונטיקט)	1
Nottingham (England)	נוטינגהאם (אנגליה)	3
Nova Scotia	נובה סקוטיה	1
Nove Mesto	עיר חדש (סלובקיה)	1
Nové Město nad Metují (Czech Republic)	נובה מסטו נאד מטויי (צ'כיה)	1
Nové Mesto nad Váhom (Slovakia)	עיר חדש (סלובקיה)	2
Nove Mesto, Vagujhely nad Vahom	עיר חדש (סלובקיה)	1
Nove Mesto, Vaguljhely	עיר חדש (סלובקיה)	1
Nove Zamky (Slovakia)	ניהיזל (סלובקיה)	3
Novi Sad (Serbia)	נובי סאד (סרביה)	2
Novohrad-Volynsʹkyĭ (Ukraine)	נובוהרד-ולינסקי (אוקראינה)	7
Novomoskovsk (Russia)	נובומוסקובסק (רוסיה)	1
Novomyrhorod (Ukraine)	נובומירהורוד (אוקראינה)	7
Novoselyt︠s︡i︠a︡ (Chernivet︠s︡ʹka oblastʹ, Ukraine)	נובוסליצה (מחוז צ'רניביאטסקאיה, אוקראינה)	4
Novosibirsk (Russia)	נובוסיבירסק (רוסיה)	1
Novoukraïnsʹkyĭ raĭon (Ukraine)	מחוז נובוקריינסקיי (אוקראינה)	2
Novozybkov (Russia)	נובוזיבקוב (רוסיה)	2
Novy Sverzhan (Belarus)	נובי סווירז'ינה (בלארוס)	1
Novyĭ I︠A︡rychiv (Ukraine)	נובי יאריצ'וב (אוקראינה)	1
Nowogródek (Poland)	נבהרדק (פולין)	5
Nowy Dwor	נובידבור (בלארוס)	2
Nowy Sącz (Poland)	צנז (פולין)	17
Numidia	נומידיה	1
Nuremberg (Germany)	נירנברג (גרמניה)	14
Nusaybin (Turkey)	נציבין (טורקיה)	1
Nușeni (Romania)	נושני (רומניה)	1
Nyeri (Kenya)	ניירי (קניה)	1
Nyírbátor (Hungary)	ניירבטור (הונגריה)	1
Nyíregyháza (Hungary)	נירג'הזה (הונגריה)	1
Nyírlugos (Hungary)	לוגאש (הונגריה)	1
Nyitra	ניטרה (סלובקיה)	4
Oak Park (Ill.)	אוק פארק (אילינוי)	2
Oakland (Calif.)	אוקלנד (קליפורניה)	2
Oberammergau (Germany)	אובראמרגאו (גרמניה)	2
Oberdorf (Germany)	אברדורף (גרמניה)	1
Oberendingen (Switzerland)	אובראנדיגן (שווייץ)	1
Obertyn (Ukraine)	אוברטין (אוקראינה)	1
Oborniki (Poland)	אובורניקי (פולין)	1
Obrzycko (Poland)	אובז'יצ'קו (פולין)	1
Óbuda (Hungary)	אובודה (הונגריה)	2
Odense (Denmark)	אודנזה (דנמרק)	2
Odesa (Ukraine)	אודסה (אוקראינה)	99
Ofakim (Israel)	אופקים (ישראל)	6
Offenbach am Main (Germany)	אופנבך אם מיין (גרמניה)	1
Ohio	אוהיו	11
Okayama-ken (Japan)	אוקאיאמה-קן (יפן)	1
Oklahoma	אוקלהומה	1
Oklahoma City (Okla.)	אוקלהומה סיטי (אוקלהומה)	3
Oklahoma City, (Okla.)	אוקלהומה סיטי (אוקלהומה)	1
Oleksandrii︠a︡ (Kirovohradsʹka oblastʹ, Ukraine)	אלכסנדריה (אוקראינה)	2
Oleyëvo-Korolëvka (Ukraine)	אוליאבו-קורולבקה (אוקראינה)	2
Olkusz (Poland)	אולקוש (פולין)	3
Olomouc (Czech Republic : Okres)	אולומואץ (צ'כיה : מחוז)	1
Olomouc (Czech Republic)	אולמיץ (צ'כיה)	1
Olyka (Ukraine)	אוליקה (אוקראינה)	1
Omaha (Neb.)	אומהה (נברסקה)	6
Omsk (Russia)	אומסק (רוסיה)	2
Ontario	אונטריו	2
Opatów (Tarnobrzeg, Poland)	אפטה (פולין)	6
Opavice (Czech Republic)	טרפלוויץ (צ'כיה)	1
Opoczno (Poland)	אופוצ'נה (פולין)	3
Oppeln (Germany)	אופלן (גרמניה)	1
Or Yehuda (Israel)	אור יהודה (ישראל)	1
Oradea (Romania)	אורדיאה מרה (רומניה)	8
Oran (Algeria)	אורן (אלג'יריה)	4
Orange (France)	אורנג' (צרפת)	1
Oranienbaum (Germany)	אורנינבאום (גרמניה)	1
Oranit (West Bank)	אורנית (גדה מערבית)	1
Oregon	אורגון	2
Orel (Orlovskai︠a︡ oblastʹ, Russia)	אורל (רוסיה)	2
Orgeev (Moldova)	אורהיוב (מולדובה)	5
Orhei, Orheev	אורהיוב (מולדובה)	1
Oria (Italy)	אוריה (איטליה)	1
Orla (Poland)	אורלה (פולין)	3
Orlando (Fla.)	אורלנדו (פלורידה)	1
Orsha (Belarus)	אורשה (בלארוס)	6
Osaka (Japan)	אוסקה (יפן)	3
Osoblaha (Czech Republic)	אוסובלאהה (צ'כיה)	2
Oss (Netherlands)	אוס (הולנד)	1
Oster (Ukraine)	אוסטר (אוקראינה)	2
Ostrava (Czech Republic)	אוסטרוה (צ'כיה)	1
Ostroh (Ukraine)	אוסטרהא (אוקראינה)	16
Ostrołęka (Ostrołęka, Poland)	אוסטרולקה (אוסטרולקה, פולין)	6
Ostrów Lubelski (Poland)	אוסטרוב לובלסקי (פולין)	1
Ostrów Mazowiecka (Poland)	אוסטרוב מזוביצק (פולין)	8
Ostrów Wielkopolski (Poland)	אוסטרוב ויילקופולסקי (פולין)	1
Ostrowiec Świętokrzyski (Poland)	אוסטרוביץ (פולין)	7
Ostryna (Belarus)	אוסטרין (בלארוס)	2
Oświęcim (Poland)	אושויץ (פולין)	4
Ottawa (Ont.)	אוטווה (אונטריו)	7
Otwock (Poland)	אוטבוצק (פולין)	2
Oujda (Morocco)	אוג'דה (מרוקו)	1
Oviedo (Spain)	אוביידו (ספרד)	1
Ovruch (Ukraine)	אוברוץ' (אוקראינה)	3
Oxford (England)	אוקספורד (אנגליה)	6
Ozarintsy (Ukraine)	אוזרינצי (אוקראינה)	1
Ożarów (Poland)	אוז'רוב (פולין)	3
Ozerna (Ternopilʹsʹka oblastʹ, Ukraine)	אוזרנה (מחוז טרנופיל, אוקריאנה)	2
Ozorków (Poland)	אזארקוו (פולין)	9
Pabianice (Poland)	פביניץ (פולין)	4
Pacanów (Poland)	פאצאנוב (פולין)	1
Pacific Palisades (Los Angeles, Calif.)	פסיפיק פליסיידס (לוס אנג'לס, קליפורניה)	1
Padua (Italy)	פדובה (איטליה)	19
Paisley	פייזלי (סקוטלנד)	1
Pakruojis (Lithuania)	פוקרוי (ליטא)	1
Paks (Hungary)	פקש (הונגריה)	3
Palanga (Lithuania)	פלנגה (ליטא)	7
Palestrina (Italy)	פלסטרינה (איטליה)	1
Palma de Mallorca (Spain)	פלמה דה מיורקה (ספרד)	1
Palmahim (Israel)	פלמחים (ישראל)	2
Panama	פנמה	1
Panama (Panama)	פנמה (פנמה)	1
Panemunė (Kaunas, Lithuania)	פונימון (קובנה, ליטא)	1
Panevezys (Lithuania)	פוניבז' (ליטא)	19
Parchim (Germany)	פרכים (גרמניה)	1
Parczew (Biała Podlaska, Poland)	פארצ'ב (בילה פודלסקה, פולין)	1
Pardes Hanna-Karkur (Israel)	פרדס חנה - כרכור (ישראל)	6
Pardubice (Czech Republic)	פרדוביצה (צ'כיה)	1
Paris (France)	פריס (צרפת)	151
Parma (Italy)	פארמה (איטליה)	1
Parod (Israel)	פרוד (ישראל)	1
Pasco (Wash.)	פסקו (וושינגטון)	1
Passaic (N.J.)	פסאיק (ניו ג'רזי)	1
Pastavy (Belarus)	פסטאווי (בלארוס)	2
Pasvalys (Lithuania)	פסווליס (ליטא)	2
Paterson (N.J.)	פטרסון (ניו ג'רזי)	2
Payerne (Switzerland)	פאיירן (שווייץ)	1
Pazardzhik (Bulgaria)	פאזארדז'יק (בולגריה)	1
Pécs (Hungary)	פץ' (הונגריה)	1
Peekskill (N.Y.)	פיקסקיל (ניו יורק)	2
Peine (Germany)	פיינה (גרמניה)	1
Pekin (Ill.)	פקין (אילינוי)	1
Pennsylvania	פנסילבניה	10
Penza (Russia)	פנזה (רוסיה)	1
Peoria (Ill.)	פאוריה (אילינוי)	1
Perei︠a︡slav-Khmelʹnyt︠s︡ʹkyĭ raĭon (Ukraine)	פרואסקארוב חמלניצקי (אוקראינה)	1
Peremyshli︠a︡ny (Ukraine)	פרמישלן (אוקראינה)	1
Permʹ (Russia)	פרם (רוסיה)	1
Perpignan (France)	פרפיניאן (צרפת)	1
Perth (W.A.)	פרת (מערב אוסטרליה)	2
Pesaro (Italy)	פזרו (איטליה)	5
Pescara (Italy)	פסקרה (איטליה)	1
Peshawar (Pakistan)	פשאוור (פקיסטן)	1
Petah Tikva (Israel)	פתח תקווה (ישראל)	77
Petahya (Israel)	פתחיה (ישראל)	1
Petrikov	פטריקוב (אוקראינה)	3
Petrovichi (Russia)	פטרוביצ'י (רוסיה)	1
Petrovka (R.S.F.S.R.)	פטרובקה (רוסיה)	1
Petrozavodsk (Russia)	פטרוזבודסק (רוסיה)	1
Pezinok (Slovakia)	פזינוק (סלובקיה)	3
Pfersee (Augsburg, Germany)	פפרסה (אוגסבורג, גרמניה)	2
Pfungstadt (Germany)	פפונגשטט (גרמניה)	1
Phalsbourg (France)	פלסבורג	1
Philadelphia (Pa.)	פילדלפיה (פנסילבניה)	34
Philippines	פיליפינים	2
Phlōrina (Greece)	פלורינה (יוון)	1
Pi︠a︡tigorsk (Russia)	פיאטיגורסק (רוסיה)	1
Piatra Neamt (Romania)	פיטרה נימץ (רומניה)	3
Picardy (France)	פיקרדי (צרפת)	1
Pidbuz︠h︡ (Ukraine)	פידבז (אוקראינה)	1
Pidhaitsi (Ukraine)	פודהייצה (אוקראינה)	8
Pidvolochysʹk (Ukraine)	פאדוואלאטשוסקא (אוקראינה)	3
Piedmont (Italy)	פיימונטה (איטליה)	1
Piešt̕any (Slovakia)	פיאסטני (סלובקיה)	1
Pietermaritzburg (South Africa)	פיטרמריצבורג (דרום אפריקה)	1
Pikeliai (Lithuania)	פיקלין (ליטא)	2
Pilica (Poland)	פיליקה (פולין)	2
Piltene (Latvia)	פילטן (לטביה)	2
Pilviškiai (Lithuania)	פילווישוק (ליטא)	6
Pilzno (Poland)	פילזנה (פולין)	1
Pinczów (Poland)	פינצוב (פולין)	9
Pinner (London, England)	פינר (לונדון, אנגליה)	2
Pinner, England	פינר (לונדון, אנגליה)	1
Pinsk (Belarus)	פינסק (בלארוס)	69
Piotrkow Trybunalski (Poland)	פיוטרקוב (פולין)	15
Piraeus (Greece)	פיראוס (יוון)	2
Pisa (Italy)	פיזה (איטליה)	4
Pithiviers (France)	פיטיוויה (צרפת)	1
Pitigliano (Grosseto, Italy)	פיטיליאנו (גרוסטו, איטליה)	3
Pittsburgh (Pa.)	פיטסברג (פנסילבניה)	11
Plainfield (N.J.)	פליינפילד (ניו ג'רזי)	1
Plains (Ga.)	פליינס (ג'ורג'יה)	1
Pławno (Poland)	פלאוונו (פולין)	2
Pleasantville	פלזנטוויל (ניו ג'רזי)	1
Pleshchenitsy (Belarus)	פלשצ'ניץ (בלארוס)	3
Pliska (Bulgaria)	פליסקה (בולגריה)	1
Płock (Poland)	פלוצק (פולין)	19
Płońsk (Poland)	פלונסק (פולין)	13
Plovdiv (Bulgaria)	פלובדיב (בולגריה)	5
Plungė (Lithuania)	פלונגין (ליטא)	5
Plzeň (Czech Republic)	פלזן (צ'כיה)	2
Pniewy (Poland)	פניאבי (פולין)	1
Pniewy, Pinne	פניאבי (פולין)	1
Poběžovice (Czech Republic)	פוביזוביצה (צ'כיה)	1
Pochaïv (Ukraine)	פיטשיב (אוקראינה)	1
Pochep (Russia)	פוצ'פ (רוסיה)	1
Podgorze (Krakow, Poland)	פודגורזה (קרקוב, פולין)	2
Podillia (Ukraine)	פודיליה (אוקראינה)	3
Podu Iloaiei (Romania)	פודו אילואיי (רומניה)	1
Pogost	פוהוסט זגורודסקי (בלארוס)	2
Pogost-Zagorodskiy (Belarus)	פוהוסט זגורודסקי (בלארוס)	1
Pohořelice (Jihomoravsky kraj, Czech Republic)	פוגוז'ליצה (מחוז מורביה הדרומית, צ'כיה)	1
Pohrebyshche (Ukraine)	פוהרבישצ'ה (אוקראינה)	2
Poissy (France)	פויסי (צרפת)	2
Poitiers (France)	פואטייה (צרפת)	1
Poland	פולין	511
Polatsk (Belarus)	פולוצק (בלארוס)	6
Polička (Czech Republic)	פוליצ'קה (צ'כיה)	1
Polná (Jihomoravský kraj, Czech Republic)	פולנה (ז'יומוראבסקי קרא, צ'כיה)	1
Polonne (Ukraine)	פולונה (אוקראינה)	5
Poltava (Ukraine)	פולטבה (אוקראינה)	16
Pont-à-Mousson (France)	פונט-א-מוסון (צרפת)	1
Ponta Delgada (Azores)	פונאה דלגדה (איים האזוריים)	4
Porazava (Belarus)	פורוזוב (בלארוס)	3
Port Arthur (Tex.)	פורט ארתור (טקסס)	2
Port Elizabeth (South Africa)	פורט אליזבת (דרום אפריקה)	1
Port Said (Egypt)	פורט סעיד (מצרים)	1
Port-au-Prince (Haiti)	פורט או פרינס (האיטי)	1
Portland (Me.)	פורטלנד (מיין)	2
Portland (Or.)	פורטלנד (אורגון)	1
Porto (Portugal)	פורטו (פורטוגל)	1
Portsmouth (England)	פורטסמות' (אנגליה)	1
Portsmouth (Va.)	פורטסמות (וירג'יניה)	1
Portugal	פורטוגל	7
Posnan,Leszno	פוזנן (פולין)	1
Potsdam (Germany)	פוטסדם (גרמניה)	3
Pottsville (Pa.)	פוטסוויל (פנסילבניה)	1
Poznań (Poland : Voivodeship)	פוזנן (פולין : מחוז)	1
Poznań (Poland)	פוזנן (פולין)	35
Praga (Warsaw, Poland)	פרגה (ורשה, פולין)	1
Prague (Czech Republic)	פראג (צ'כיה)	107
Prato (Italy)	פראטו (איטליה)	1
Preiļi (Latvia)	פריילי (לטביה)	2
Prerau	פררוב (מחוז אולומואץ, צ'כיה)	2
Přerov (Olomoucký kraj, Czech Republic)	פררוב (מחוז אולומואץ, צ'כיה)	1
Presov (Slovakia)	פרשוב (סלובקיה)	1
Preston	פרסטון (לנקשייר, אנגליה)	2
Pretoria (South Africa)	פרטוריה (דרום אפריקה)	3
Prienai (Lithuania)	פרינאי (ליטא)	2
Princeton (N.J.)	פרינסטון (ניו ג'רזי)	3
Pripet Marshes (Belarus and Ukraine)	ביצות פריפיאט (בלארוס ואוקראינה)	1
Proskuriv (Ukraine)	פרוסקוריב (אוקראינה)	6
Prostějov (Czech Republic)	פרוסטיוב (צ'כיה)	10
Proszowice (Poland : Powiat)	פרושוביצה (פולין : מחוז)	2
Provence (France)	פרובנס (צרפת)	1
Providence (R.I.)	פרובידנס (רוד איילנד)	1
Prussia (Germany)	פרוסיה (גרמניה)	2
Pruz︠h︡any (Belarus)	פרוז'ני (בלארוס)	7
Pryluky (Ukraine)	פרילוקי (אוקראינה)	8
Przasnysz (Poland)	פרושניץ (פולין)	4
Przedbórz (Piotrków Trybunalski, Poland)	פשדבוז (פיוטרקוב טריבונלסקי, פולין)	2
Przemyśl (Poland)	פשמישל (פולין)	35
Przeworsk (Poland)	פרשעווארסק (פולין)	2
Przysucha (Poland)	פשיסחא (פולין)	3
Pskov (Russia)	פסקוב (רוסיה)	4
Pszczyna (Poland)	פשצ'ינה (פולין)	1
Puerto Rico	פוארטו ריקו	1
Puławy (Poland)	פולבי (פולין)	2
Pułtusk (Poland)	פולטוסק (פולין)	7
Pumpėnai (Lithuania)	פומפיאן (ליטא)	2
Pusan (Korea)	פוסן (קוריאה)	1
Putney (London, England)	פאטני (לונדון, אנגליה)	1
Putnok (Hungary)	פוטנוק (הונגריה)	1
Qābis (Tunisia)	גבס (תוניסיה)	14
Qafṣah (Tunisia)	גאפסה (תוניסיה)	1
Qayrawān (Tunisia)	קירואן (תוניסיה)	2
Qingdao (China)	צ'ינגדאו (סין)	1
Québec (Province)	קוויבק (מחוז)	1
Quedlinburg (Germany)	קוודלינבורג (גרמניה)	1
Queens (New York, N.Y.)	קווינס (ניו יורק, ניו יורק)	3
Querfurt (Germany)	קוורפורט (גרמניה)	1
Quezaltenango (Guatemala)	קוויזלטננגו (גואטמלה)	1
Quilmes (Argentina)	קילמס (ארגנטינה)	1
Quito (Ecuador)	קיטו (אקוודור)	1
Ra'ananna (Israel)	רעננה (ישראל)	12
Rachów (Poland)	רחוב (פולין)	1
Racibórz (Poland)	רטיבור (פולין)	1
Racine (Wis.)	רייסין (ויסקונסין)	1
Radashkovichy (Belarus)	רדושקוביצה (בלארוס)	5
Radautsi (Romania)	רדאוץ (רומניה)	3
Radom (Województwo Mazowieckie, Poland)	ראדום (מדינת מזובייצק, פולין)	22
Radomsko (Poland)	רדומסק (פולין)	13
Radomysl Wielki (Poland)	רדומישל (פולין)	4
Radunʹ (Belarus)	רדין (בלארוס)	1
Radymno (Poland)	רדים (פולין)	5
Radyvyliv (Ukraine)	רדזיווילוב (אוקראינה)	2
Radziłów (Poland)	ראדזילוב (פולין)	1
Radzymin (Poland)	רדזימין (פולין)	7
Radzyn	רזין (פולין)	2
Radzyń Podlaski (Poland)	ראדזין פודלסקי (פולין)	2
Raguva (Lithuania)	רוגבה (ליטא)	2
Rahachoŭ (Belarus)	רוגצ'וב (בלארוס)	6
Rajgród (Poland)	רייגרוד (פולין)	4
Rakaŭ (Belarus)	ראקוב (בלארוס)	3
Ramat Aviv (Tel Aviv-Yafo, Israel)	רמת אביב (תל אביב-יפו, ישראל)	1
Ramat Bet Shemesh (Bet Shemesh, Israel)	רמת בית שמש (בית שמש, ישראל)	1
Ramat David (Israel)	רמת דוד (ישראל)	1
Ramat Ef'al (Ramat Gan, Israel)	רמת אפעל (רמת גן, ישראל)	1
Ramat Gan (Israel)	רמת גן (ישראל)	47
Ramat Hadar (Hod Hasharon, Israel)	רמת הדר (הוד השרון, ישראל)	1
Ramat Hakovesh (Israel)	רמת הכובש (ישראל)	5
Ramat Hasharon (Israel)	רמת השרון (ישראל)	6
Ramat Hashofet (Israel)	רמת השופט (ישראל)	2
Ramat Rahel (Israel)	רמת רחל (ישראל)	2
Ramat Yohanan (Israel)	רמת יוחנן (ישראל)	1
Ramerupt (France)	רמרו (צרפת)	1
Ramla (Israel)	רמלה (ישראל)	5
Ramot Menashe (Kibbutz) (Israel)	רמות מנשה (קיבוץ) (ישראל)	2
Ramsgate (England)	רמסגייט (אנגליה)	1
Rannen (Israel)	רנן (ישראל)	1
Raseiniai (Lithuania)	ראסייני (ליטא)	15
Ratne (Ukraine)	רטנה (אוקראינה)	1
Rava-Rusʹka (Ukraine)	ראווה רוסקה (אוקראינה)	9
Rawicz (Leszno, Poland)	רביץ' (פולין)	7
Re'im (Israel)	רעים (ישראל)	1
Reading (England)	רדינג (אנגליה)	2
Reading (Pa.)	רידינג (פנסילבניה)	2
Recanati (Italy)	רקנאטי (איטליה)	2
Rechnitz (Austria)	רכניץ (אוסטריה)	2
Rėchytsa (Belarus)	רציצה (בלארוס)	6
Recife (Brazil)	רסיפה (ברזיל)	3
Redon (France)	רדון (צרפת)	1
Regavim (Israel)	רגבים (ישראל)	1
Regensburg (Germany)	רגנסבורג (גרמניה)	2
Reggio Emilia (Italy)	רג'יו (איטליה)	3
Réguisheim (France)	רעגיסהיים (צרפת)	1
Rehovot (Israel)	רחובות (ישראל)	57
Reims (France)	ריימס (צרפת)	2
Rekhasim (Israel)	רכסים (ישראל)	1
Remscheid (Germany)	רמשייד (גרמניה)	1
Reshafim (Israel)	רשפים (ישראל)	1
Revadim (Israel)	רבדים (ישראל)	2
Revivim (Israel)	רביבים (ישראל)	1
Rexingen (Horb am Neckar, Germany)	רקסינגן (הורב אם נקאר, גרמניה)	1
Reykjavík (Iceland)	רייקיאוויק (איסלנד)	1
Rēzekne (Latvia)	רזקנה (לטביה)	1
Rheydt (Germany)	ריידט (גרמניה)	1
Rhode Island	רוד אילנד	1
Rhodes (Greece)	רודוס (יוון)	8
Ribatejo (Portugal)	ריבטז'ו (פורטוגל)	1
Ribniţa (Moldova)	ריבניצה (מולדובה)	1
Richland (Wash.)	ריצ'לנד (וושינגטון)	1
Richmond (Va.)	ריצ'מונד (וירג'יניה)	2
Ridāʻ (Yemen)	רידא (תימן)	1
Rietavas (Lithuania)	ריטובה (ליטא)	7
Rieti (Italy)	רייטי (איטליה)	1
Riga (Latvia)	ריגה (לטביה)	1
Rijeka (Croatia)	ריאקה (קרואטיה)	1
Rinnatya (Israel)	רינתיה (ישראל)	1
Rio de Janeiro (Brazil)	ריו דה ז'ניירו (ברזיל)	17
Rishon Letsiyon (Israel)	ראשון לציון (ישראל)	44
Rishpon (Israel)	רשפון (ישראל)	1
Rivne (Rivnensʹka oblastʹ, Ukraine)	רובנו (מחוז רובנו, אוקראינה)	5
Rivne (Zakarpatsʹka oblastʹ, Ukraine)	רובנו (מחוז זקרפטיה, אוקראינה)	1
Rivoli (Italy)	ריבולי (איטליה)	1
Riyadh (Saudi Arabia)	ריאד (ערב הסעודית)	2
Rochdale (England)	רושדייל (אנגליה)	1
Rochefort	רושפור (צרפת)	1
Rochester (N.Y.)	רוצ'סטר (ניו יורק)	4
Rockford (Ill.)	רוקפורד (אילינוי)	1
Rockport (Mass.)	רוקפורט (מסצ'וסטס)	1
Rohatyn (Ukraine)	רוהטין (אוקראינה)	5
Rokiškis (Lithuania)	רוקישקיס (ליטא)	2
Rokytne (Rivnensʹka oblastʹ, Ukraine)	רוקיטנה (מחוז רובנו, אוקראינה)	1
Roman (Romania)	רומאן (רומניה)	2
Romania	רומניה	175
Romanivka (Ukraine)	רומנובקה (אוקראינה)	2
Rome	רומי	18
Rome (Italy)	רומא (איטליה)	31
Romny (Ukraine)	רומני (אוקראינה)	8
Ropczyce (Poland)	רופשיץ (פולין)	2
Rosario (Santa Fe, Argentina)	רוסאריו (סנטה פה, ארגנטינה)	4
Rosh Pina (Israel)	ראש פינה (ישראל)	9
Rosovice (Czech Republic)	ראסאוויץ (צ'כיה)	1
Rostov (Russia)	רוסטוב (רוסיה)	2
Rostov-na-Donu (Russia)	רוסטוב על הדון	4
Rotmistrovka (Ukraine)	רחמיסטריבקה (אוקראינה)	1
Rotterdam (Netherlands)	רוטרדם (הולנד)	10
Rottweil (Germany)	רוטווייל (גרמניה)	1
Rouen (France)	רואן (צרפת)	2
Rousínov (Jihomoravský kraj, Czech Republic)	רוסינוב (מורביה הדרומית, צ'כיה)	1
Różan (Poland)	רוז'ן (פולין)	1
Rozdil (Ukraine)	רוזדיל (אוקראינה)	3
Rozhanka (Belarus)	רוז'נקה (בלארוס)	1
Roz︠h︡ni︠a︡tiv (Ukraine)	רוז'ניטייב (אוקראינה)	4
Roz︠h︡yshche (Ukraine)	רוז'ישץ' (אוקראינה)	3
Rozwadów (Poland)	רוזודוב (פולין)	8
Rubiazhevichy (Belarus)	רובזויץ (בלארוס)	1
Rudky (Lʹvivsʹka oblastʹ, Ukraine)	רודקי (מחוז לביב, אוקראינה)	2
Runkel (Germany)	רונקל (גרמניה)	1
Ruse (Bulgaria)	רוסצ'וק (בולגריה)	5
Rusovce (Bratislava, Slovakia)	רוסובצה (ברטיסלבה, סלובקיה)	1
Ruthenia (Czechoslovakia)	רותניה (צ'כיה)	2
Ruzhany (Belarus)	רוז'ינוי (בלארוס)	9
Rybinsk (I︠A︡roslavskai︠a︡ oblastʹ, Russia)	ריבינסק (מחוז ירוסלבסקיה, רוסיה)	1
Rychwał (Poland)	רוכוואהל (פולין)	1
Rye (England)	ריי (אנגליה)	1
Rymanów (Poland)	רימנוב (פולין)	2
Rypin (Poland)	ריפין (פולין)	6
Rzeszów (Poland)	רישא (פולין)	24
Rz︠h︡yshchiv (Ukraine)	רזישצ.ב (אוקראינה)	2
Săcel (Romania)	סיטשעל (רומניה)	1
Sacramento (Calif.)	סקרמנטו (קליפורניה)	1
Sadhora (Chernivtsi, Ukraine)	סדיגורה (צ'רנוביץ, אוקראינה)	2
Ṣafāqis (Tunisia)	ספקס (תוניסיה)	1
Saginaw (Mich.)	סאגינאו (מישיגן)	1
Saigon (Vietnam)	סייגון (וייטנאם)	1
Saint Gall (Switzerland)	סנט גאלן (שווייץ)	1
Saint Joseph (Mo.)	סנט ג'וסף (מיזורי)	2
Saint Louis (Mo.)	סנט לואיס (מיזורי)	2
Saint Paul (Minn.)	סנט פאול (מינסוטה)	5
Saint Petersburg (Russia)	פטרבורג (רוסיה)	79
Saint-Dié (France)	סן-דיי (צרפת)	1
Saint-Etienne (Loire, France)	סנט אטיין (לואר, צרפת)	1
Saint-Malo (France)	סן-מאלו (צרפת)	1
Saint-Omer (Pas-de-Calais, France)	סן עומר (פה דה קאלה, צרפת)	1
Šakiai (Lithuania)	שקי (ליטא)	5
Salerno (Italy)	סלרנו (איטליה)	2
Salford (England)	סלפורד (אנגליה)	1
Salgótarján (Hungary)	שלגוטרין (הונגריה)	1
Salinas	סלינס (קליפורניה)	1
Salisbury (England)	סולסברי (אנגליה)	1
Salt Lake City (Utah)	סולט לייק סיטי (יוטה)	7
Salvador (Brazil)	סלבדור (ברזיל)	1
Salzburg (Austria)	זלצבורג (אוסטריה)	4
Samara (Russia)	סמרה (רוסיה)	1
Samarqand (Uzbekistan)	סמרקנד (אוזבקיסטן)	6
Sambir (Sambirsʹkyĭ raĭon, Ukraine)	סמבור (אוקראינה)	16
Samokov (Bulgaria)	סמוקוב (בולגריה)	2
Šamorín (Slovakia)	שומוריה (סלובקיה)	1
San Antonio (Tex.)	סן אנטוניו (טקסס)	2
San Diego (Calif.)	סן דייגו (קליפורניה)	2
San Felice sul Panaro (Italy)	סן פליצ'ה סול פראנו (איטליה)	1
San Francisco (Calif.)	סן פרנסיסקו (קליפורניה)	22
San Juan (P.R.)	סן חואן (פוארטו ריקו)	1
San Miguel (El Salvador)	סן מיגל (אל סלוודור)	1
San Miguel de Tucuman (Argentina)	סן מיגל דה טוקומאן (ארגנטינה)	2
San'a (Yemen)	צנעא (תימן)	32
Sandersleben (Germany)	סנדרסלבן (גרמניה)	4
Sandomierz (Poland)	סנדומיז' (פולין)	3
Sandringham (England)	סנדרינגהם (אנגליה)	1
Sandūr (Iraq)	צנדור (עיראק)	1
Sannicandro Garganico (Italy)	סניקנדרו גרגניקו (איטליה)	1
Sanok (Poland)	סנוק (פולין)	13
Sansepolcro (Italy)	סנספולקרו (איטליה)	1
Santa Cruz de Tenerife (Canary Islands)	סנטה קרוז דה טנריף (האיים הקנריים)	1
Santa Fe (Argentina)	סנטה פה (ארגנטינה)	1
Santiago (Chile)	סנטיאגו (צ'ילה)	11
Santiago de Cuba (Cuba)	סנטיאגו דה קובה (קובה)	1
Santo Domingo (Dominican Republic)	סנטו דומינגו (רפובליקה דומניקנית)	2
Săpînța (Romania)	ספינצה (רומניה)	1
Saqqiz (Iran)	סביז (איראן)	1
Sarajevo (Bosnia and Hercegovina)	סריבו (בוסניה והרצגובינה)	14
Sarata (Ukraine)	סאראטה (אוקראינה)	1
Saratov (Russia)	סרטוב (רוסיה)	4
Sardinia (Italy)	סרדיניה (איטליה)	1
Sarid (Israel)	שריד (ישראל)	5
Sarnia (Ont.)	סרניה (אונטריו)	1
Sárospatak (Hungary)	שרושפטק (הונגריה)	1
Sasa (Israel)	סאסא (ישראל)	2
Sasiv (Ukraine)	ססוב (אוקראינה)	9
Sataniv (Ukraine)	סאטאניב (אוקראינה)	10
Sátoraljaújhely (Hungary)	אוהל (הונגריה)	16
Satu Mare (Romania : Județ)	סאטו מארה (רומניה : מחוז)	2
Saxony (Germany)	סקסוניה (גרמניה)	1
Saxony-Anhalt (Germany)	סקסוניה-אנהלט (גרמניה)	2
Schenectady (N.Y.)	סקנקטדי (ניו יורק)	1
Schilde (Netherlands)	שילדה (הולנד)	1
Schmalkalden (Germany)	שמלדקן (גרמניה)	1
Schöneberg (Berlin, Germany)	שינהברג (ברלין, גרמניה)	1
Schweinfurt (Germany)	שוויינפורט (גרמניה)	2
Scotland	סקוטלנד	20
Scranton (Pa.)	סקרנטון (פנסילבניה)	1
Sculeni (Romania)	סקולני (רומניה)	3
Seattle (Wash.)	סיאטל (ושינגטון)	6
Sebezh (Russia)	סבז' (רוסיה)	2
Sede Nahum (Israel)	שדה נחום (ישראל)	1
Sede Nehemya (Israel)	שדה נחמיה (ישראל)	2
Sede Ya'akov (Israel)	שדה יעקב (ישראל)	1
Sederot (Israel)	שדרות (ישראל)	3
Sedot Yam (Israel)	שדות ים (ישראל)	1
Šeduva (Lithuania)	שדובה (ליטא)	6
Sędziszów (Poland)	סאנדזישוב (פולין)	5
Sefrou (Morocco)	צפרו (מרוקו)	9
Segev Shalom (Israel)	שגב-שלום (ישראל)	1
Segovia (Spain)	סגוביה (ספרד)	1
Seine-et-Marne, Meaux	סן ומארן (צרפת)	1
Seine-Saint-Denis (France)	סנס-סן-דני (צרפת)	1
Seirijai (Lithuania)	סרהיי (ליטא)	2
Sejny (Poland)	סיני (פולין)	5
Sélestat (France)	סלסטה (צרפת)	1
Selets (Belarus)	סילץ (בלארוס)	6
Sembach (Germany)	סמבאך (גרמניה)	1
Senta (Serbia)	זנטה (סרביה)	2
Seoul (Korea)	סיאול (קוריאה)	5
Seppois-le-Bas (France)	ספואה (צרפת)	1
Sered (Slovakia)	סרד (סלובקיה)	2
Serock (Warsaw, Poland)	סרוצק (ורשה, פולין)	2
Serrai (Greece)	סירס (יוון)	2
Šėta (Lithuania)	שטא (ליטא)	1
Sète (France)	סטה (צרפת)	1
Sevastopolʹ (Ukraine)	סבסטופול (אוקראינה)	2
Seville (Spain)	סויליה (ספרד)	3
Sha'alvim (Israel)	שעלבים (ישראל)	1
Sha'ar Ha'amakim (Israel)	שער העמקים (ישראל)	3
Sha'ar Hagolan (Israel)	שער הגולן (ישראל)	1
Sha'ar Hanegev (Israel)	שער הנגב (ישראל)	1
Sha'arayim (Rehovot, Israel)	שעריים (רחובות, ישראל)	1
Shamerat (Israel)	שמרת (ישראל)	2
Shamir (Israel)	שמיר (ישראל)	1
Shandong Sheng (China)	שאנדונג שנג (סין)	1
Shanghai (China)	שנחאי (סין)	6
Sharhorod (Ukraine)	שרגורוד (אוקראינה)	2
Shave Tsiyyon (Israel)	שבי ציון (ישראל)	1
Shchuchyn (Belarus)	שצ'וצ'ין (בלארוס)	10
Sheboygan (Wis.)	שבויגן (ויסקונסין)	2
Shefar'am (Israel)	שפרעם (ישראל)	1
Shefayim (Israel)	שפיים (ישראל)	4
Sheffield (England)	שפילד (אנגליה)	1
Shenyang (Liaoning Sheng, China)	שן-יאנג (מחוז ליאונינג, סין)	1
Shepetivka (Ukraine)	שפטובקה (אוקראינה)	1
Shereshevo (Belarus)	שערשעוו (בלארוס)	5
Sherman	שרמן (טקסס)	1
Shimshit (Israel)	שמשית (ישראל)	2
Shīrāz (Iran)	שיראז (איראן)	7
Shkloŭ (Belarus)	שקלוב (בלארוס)	20
Shklov, Mogilev, Belarus	שקלוב (בלארוס)	1
Shoham (Israel)	שוהם (ישראל)	2
Shoval (Israel)	שובל (ישראל)	3
Shpola (Ukraine)	שפולה (אוקראינה)	3
Shreveport (La.)	שריבפורט (לואיזיאנה)	1
Shrewsbury (England)	שרוסברי (אנגליה)	1
Shropshire (England)	שרופשייר (אנגליה)	1
Shumi︠a︡chi (Russia)	שומיאצ'י (רוסיה)	5
Shumsʹk (Ukraine)	שומסק (אוקראינה)	1
Šiaulėnai (Lithuania)	שוואלן (ליטא)	1
Šiauliai (Lithuania)	שול (ליטא)	19
Siberia (Russia)	סיביר (רוסיה)	5
Sichuan Sheng (China)	סצ'ואן שנג (סין)	1
Sidon (Lebanon)	צידון (לבנון)	1
Siedlce (Poland)	שדלץ (פולין)	31
Siemiatycze (Poland)	סמיטיץ' (פולין)	10
Siena (Italy)	סיינה (איטליה)	4
Sieniawa (Przemyśl, Poland)	שיניוה (פשמישל, פולין)	8
Sieradz (Poland)	שייראדז (פולין)	3
Sierpc (Poland : Powiat)	שרפץ (פולין : מחוז)	2
Sighet (Romania)	סיגט (רומניה)	8
Sighetu Marmației (Romania)	סיגטו מרמציי (רומניה)	4
Sighișoara (Romania)	סיגישוארה (רומניה)	2
Šiluva (Lithuania)	סילובה (ליטא)	1
Silver Spring (Md.)	סילבר ספרינג (מרילנד)	1
Simferopol (Ukraine)	סימפרופול (אוקראינה)	2
Simla (India)	סימלה (הודו)	2
Sinai (Egypt)	סיני (מצרים)	1
Sindi (Estonia)	סינדי (אסטוניה)	1
Singapore	סינגפור	1
Sînnicolau Mare (Romania)	סיניקולאו מארו (רומניה)	1
Sinsheim (Germany)	סינסהיים (גרמניה)	1
Siófok (Hungary)	סיופוק (הונגריה)	1
Siponto (Italy)	סיפונטו (איטליה)	1
Siret (Romania)	סירט (רומניה)	5
Širvintos (Lithuania)	שירווינט (ליטא)	6
Skalat (Ukraine)	סקלט (אוקראינה)	6
Skaudvilė (Lithuania)	שקודוויל (ליטא)	3
Skierniewice (Poland)	סקרניביץ (פולין)	3
Skole (Ukraine)	סקולה (אוקראינה)	3
Skopje (Macedonia)	סקופיה (מקדוניה)	1
Skryhiczyn (Poland)	סקריהיטשן (פולין)	1
Skuodas (Lithuania)	שקוד (ליטא)	4
Skvyra (Ukraine)	סקווירה (אוקראינה)	8
Skwierzyna (Poland)	שווערין (פולין)	1
Slavonia (Croatia)	סלבוניה (קרואטיה)	1
Slavuta (Ukraine)	סלוויטה (אוקראינה)	2
Sławatycze (Poland)	סלווטיצ'ה (פולין)	1
Sławków (Poland)	סלבקוב (פולין)	1
Slonim (Belarus)	סלונים (בלארוס)	39
Slovakia	סלובקיה	8
Slovenia	סלובניה	1
Slutsk (Belarus)	סלוצק (בלארוס)	33
Smila (Cherkasʹka oblastʹ, Ukraine)	סמילה (מחוז צ'רקסקה, אוקראינה)	3
Smilavichy (Belarus)	סמילביטש (בלארוס)	2
Smolensk (Russia)	סמולנסק (רוסיה)	3
Smolyany (Belarus)	סמאליאן (בלארוס)	2
Smorgon (Belarus)	סמרגון (בלארוס)	16
Sni︠a︡tyn (Ukraine)	שניאטין (אוקראינה)	10
Snovsk (Ukraine)	סנוסק (אוקראינה)	3
Sobolevka (Ukraine)	סאביליפקע (אוקראינה)	1
Sobotište (Slovakia)	סובוטיסטה (סלובקיה)	2
Sochaczew (Poland)	סוכטשוב (פולין)	6
Sochi (Russia)	סוצ'י (רוסיה)	1
Sofia (Bulgaria)	סופיה (בולגריה)	28
Soho (London, England)	סוהו (לונדון, אנגליה)	1
Sokalʹ (Ukraine)	סוקאל (אוקראינה)	4
Sokolivka (Vasylʹkivsʹkyĭ raĭon, Kiev, Ukraine)	סוקוליבקה (קייב, אוקראינה)	1
Sokółka (Poland)	סוקולקה (פולין)	2
Sokołów Podlaski (Poland)	סוקולוב פודלסקי (פולין)	6
Sokoły (Łomża, Poland)	סוקולי (לומזה, פולין)	7
Sokyri︠a︡ny (Ukraine)	סקורן (אוקראינה)	3
Solingen (Germany)	סולינגן (גרמניה)	3
Solotvyno (Ukraine)	סולוטבינו (אוקראינה)	1
Sombor (Serbia)	סומבור (סרביה)	1
Somerville (N.J.)	סומרוויל (ניו ג'רזי)	1
Sontheim (Heilbronn, Germany)	סונטהיים (היילברון, גרמניה)	1
Sopron (Hungary)	שופרון (הונגריה)	1
Sora, Lazio, Italy	סורה (איטליה)	1
Soroca (Moldova)	סורוקה (מולדובה)	3
Sosnowiec (Wojewodztwo Slaskie, Poland)	סוסנוביץ (שלזיה, פולין)	18
South Africa	דרום אפריקה	39
South America	אמריקה הדרומית	1
South Carolina	דרום קרולינה	1
South Dakota	דקוטה הדרומית	2
South Shields (England)	דרום שילדס (אנגליה)	2
Southampton (England)	סאות'המפטון (אנגליה)	1
Southampton (N.Y.)	סאות'מפטון (ניו יורק)	1
Southfield (Mich.)	סאותפילד (מישיגן)	1
Southport (England)	סאותפורט (אנגליה)	2
Soviet Union	ברית המועצות	10
Spain	ספרד	60
Spartanburg County (S.C.)	מחוז ספרטנבורג (דרום קרולינה)	1
Speyer (Germany)	שפייר (גרמניה)	2
Spišská Stará Ves (Slovakia)	זפסופלו (סלובקיה)	2
Springfield (Mass.)	ספרינגפילד (מסצ'וסטס)	3
Springfield (Ohio)	ספרינגפילד (אוהיו)	1
Śrem (Poland)	סרם (פולין)	1
Srem, Schrimm	סרם (סרביה וקרואטיה)	1
St. John's (N.L.)	סנט ג'ונ'ס (ניופאונדלנד)	1
St. Thomas, Virgin Island	סנט תומאס (איי הבתולה)	1
Stade	סטאד (סקסוניה תחתונה, גרמניה)	1
Stamford (Conn.)	סטמפורד (קונטיקט)	1
Stanislav (Ukraine)	סטניסלב (אוקראינה)	16
Stanmore (London, England)	סטנמור (לונדון, אהגליה)	1
Stara Zagora (Bulgaria)	סטארה זגורה (בולגריה)	1
Stargard Szczeciński (Poland)	סטרגרד שצ'צ'ינסקי (פולין)	1
Starobin (Belarus)	סטרובין (בלארוס)	5
Starodub (Russia)	סטארודוב (רוסיה)	3
Starokosti︠a︡ntyniv (Ukraine)	סטארוקוסטיאנטיניב (אוקראינה)	6
Staryĭ Sambir (Ukraine)	סטארי סמביר (אוקראינה)	1
Staszów (Tarnobrzeg, Poland)	סטשוב (פולין)	1
Staten Island (New York, N.Y.)	סטטן איילנד (ניו יורק, ניו יורק)	2
Staunton (Va.)	סטונטון (וירג'יניה)	1
Stavky (Veselynivsʹkyĭ raĭon, Ukraine)	סטאוויסק (אוקראינה)	1
Stawiski (Poland)	סטויסק (פולין)	7
Stefănești (Romania)	שטפנשטי (רומניה)	2
Steinbach (Man.)	סטיינבך (מניטובה)	2
Steinhart (Germany)	שטיינהרט (גרמניה)	1
Stettin (Germany)	שטטין (גרמניה)	1
Štip (Macedonia)	שטיפ (מקדוניה)	1
Stochov (Czech Republic)	סטוכוב (צ'כיה)	1
Stockholm (Sweden)	סטוקהולם (שבדיה)	12
Stoke-on-Trent (England)	סטוק און טרנט (אנגליה)	2
Stolin (Belarus)	סטולין (בלארוס)	4
Storoz︠h︡ynet︠s︡ʹ (Ukraine)	סטורוז'ינץ (אוקראינה)	4
Stoubtsy (Minskaia voblasts, Belarus)	סטוובצי (מחוז מינסק, בלארוס)	2
Strabychovo (Ukraine)	סטראביצ'ובו (אוקראינה)	1
Strakonice (Czech Republic)	סטרקוניצ'ה (צ'כיה)	1
Strasbourg (France)	שטרסבורג (צרפת)	14
Stratford (Conn.)	סטרטפורד (קונטיקט)	1
Stratford-upon-Avon (England)	סטרטפורד על נהר אייבון (אנגליה)	1
Stratyn (Ukraine)	סטראטין (אוקראינה)	3
Stropkov (Slovakia)	סטרופקוב (סלובקיה)	5
Stryĭ (Ukraine)	סטריי (אוקראינה)	16
Strzelin (Poland)	סצלין (פולין)	1
Strzelno (Wojewodztwo Kujawsko-Pomorskie, Poland)	סטשלנו (מחוז קויאוויה-פומרניה)	1
Strzyżów (Rzeszów, Poland)	סטז'יז'וב (פולין)	4
Stupava (Slovakia)	שטומפה (סלובקיה)	3
Stupsk (Poland)	סטופסק (פולין)	1
Stuttgart (Germany)	שטוטגרט (גרמניה)	11
Stuttgart Region (Germany)	אזור שטוטגרט (גרמניה)	1
Styria (Austria)	שטיריה (אוסטריה)	1
Subiaco (Italy)	סוביאקו (איטליה)	1
Subotica (Subotica, Serbia)	סובוטיקה (סובוטיקה, סרביה)	2
Suceava (Romania)	שוץ (רומניה)	5
Suchowola (Poland)	סוחובולה (פולין)	1
Sudan	סודאן	3
Sudbury (Ont.)	סודברי (אונטריו)	1
Sudilkov (Ukraine)	סודילקוב (אוקראינה)	4
Suffolk (England)	סאפוק (אנגליה)	2
Sūhāj (Egypt)	סוהאג (מצרים)	1
Sulz	זולץ (פורארלברג, אוסטריה)	1
Sunderland, England	סנדרלנד (טיין ווייר, אנגליה)	2
Suplacu de Barcău (Romania)	ספלק (רומניה)	1
Surabaya (Indonesia)	סורביה (אינדונזיה)	1
Surrey	סארי (אנגליה)	1
Surrey (England)	סארי (אנגליה)	1
Suwałki (Poland)	סובלקי (פולין)	32
Svaliava (Ukraine)	סבליאבה (אוקראינה)	1
Švenčionys (Lithuania)	שוינצין (ליטא)	8
Svirzh (Ukraine)	שווירש (אוקראינה)	2
Svislach (Hrodzenskaia voblasts, Belarus)	סוויסלוץ' (מחוז הורדנה, בלארוס)	9
Swansea (Wales)	סוונסי (ויילס)	1
Swarzędz (Poland)	שוורזנץ (פולין)	2
Sweden	שבדיה	30
Switzerland	שווייץ	39
Sydney (N.S.)	סידני (נובה סקוטיה)	1
Sydney (N.S.W.)	סידני (אוסטרליה)	11
Syracuse (Italy)	סירקיוז (איטליה)	3
Syracuse (N.Y.)	סירקיוז (ניו יורק)	1
Syria	סוריה	4
Syzranʹ (Russia)	סיזרן (רוסיה)	1
Szadek (Łódź, Poland)	שדיק (פולין)	2
Szamocin (Piła, Poland : Voivodeship)	שאמוצ'ין (פילה, פולין : מחוז)	1
Szamotuły (Poland)	שמוטולי (פולין)	2
Szczebrzeszyn (Poland)	שצ'בז'שין (פולין)	3
Szczecin, Stettin	שצ'צ'ין (פולין)	1
Szczekociny (Poland)	שצ'קוצ'ין (פולין)	1
Szeged (Hungary)	סגד (הונגריה)	2
Székesfehérvár (Hungary)	סקשפהרור (הונגריה)	3
Szendrő (Hungary)	סנדרו (הונגריה)	2
Szerencs (Hungary)	סרנץ' (הונגריה)	5
Szolnok (Hungary)	סולנוק (הונגריה)	1
Szombathely (Hungary)	סומבטהי (הונגריה)	1
Szrensk (Poland)	שרנסק (פולין)	5
Szydłów (Województwo Świętokrzyskie, Poland)	שידלוב (פולין)	2
Szydłowiec (Województwo Mazowieckie, Poland)	שידלוביץ (מדינת מזובייצק, פולין)	5
Szydłowiec, Radom, Poland	שידלוביץ (מדינת מזובייצק, פולין)	1
Tab (Hungary)	טאב (הונגריה)	1
Taegu (Korea)	טאגו (קוריאה)	1
Tafilalt	תאפילאלת (מרוקו)	1
Tafilalt (Morocco)	תאפילאלת (מרוקו)	3
Taganrog (Russia)	טגנרוג (רוסיה)	1
Taipei (Taiwan)	טייפה (טאיוואן)	1
Taiwan	טאיוואן	2
Tajikistan	טג'יקיסטן	3
Tal'ne (Ukraine)	טלנה (אוקראינה)	3
Talachyn (Belarus)	טאלאטשין (בלארוס)	3
Tallahassee (Fla.)	טלהאסי (פלורידה)	1
Tallinn (Estonia)	טאלין (אסטוניה)	1
Tállya (Hungary)	טאליה (הונגריה)	1
Talmon (West Bank)	טלמון (גדה מערבית)	1
Tamil Nadu (India)	טמיל נאדו (הודו)	1
Tampere (Finland)	טמפרה (פינלנד)	1
Tamra (Israel)	טמרה (ישראל)	3
Tangier (Morocco)	טנג'יר (מרוקו)	6
Taormina (Italy)	טאורמינה (איטליה)	1
Tarashcha (Ukraine)	טרשצ'ה (אוקראינה)	1
Tarnobrzeg (Poland)	טרנובז'ג (פולין)	13
Tarnogród (Poland)	טארנוגרוד (פולין)	5
Tartu (Estonia)	טרטו (אסטוניה)	3
Tashkent (Uzbekistan)	טשקנט (אוזבקיסטן)	9
Tasnad (Romania)	טשנד (רומניה)	2
Taurage (Lithuania)	טאורגה (ליטא)	10
Teaneck (N.J.)	טינק (ניו ג'רזי)	1
Tébessa (Algeria)	טבסה (אלג'יריה)	1
Tecklenburg (Germany)	טקלנבורג (גרמניה)	1
Teddington (London, England)	טדינגטון (לונדון, אנגליה)	1
Tegucigalpa, Francisco Morazán, Honduras	טגוסיגלפה (הונדורס)	1
Tehran (Iran)	טהרן (איראן)	14
Tel Adashim (Israel)	תל עדשים (ישראל)	1
Tel Arad (Israel)	תל ערד (ישראל)	1
Tel Aviv-Yafo (Israel)	תל אביב-יפו (ישראל)	527
Tel-Yosef (Israel)	תל יוסף (ישראל)	7
Telamim (Israel)	תלמים (ישראל)	1
Telekhany (Belarus)	טלכן (בלארוס)	2
Telenești (Moldova : Raionul)	טלנשטי (מולדובה : מחוז)	6
Telšiai (Lithuania)	טלז (ליטא)	7
Tennessee	טנסי	1
Tenterden (England)	טנטרדן (אנגליה)	1
Teplice (Czech Republic)	טפליצה (צ'כיה)	1
Terebovli︠a︡ (Ukraine)	טרמבובלה (אוקראינה)	1
Ternopilʹ (Ukraine)	טרנופול (אוקראינה)	20
Terre Haute (Ind.)	טרה הוט (אינדיאנה)	3
Texas	טקסס	4
Thames Valley, England	עמק התמזה (אנגליה)	1
Thannhausen (Germany)	תאנהאוזן (גרמניה)	1
Thessalonikē (Greece)	סלוניקי (יוון)	125
Thrace	תראקיה	1
Tʻbilisi (Georgia)	טביליסי (גאורגיה)	8
Tianjin (China)	טיאנג'ין (סין)	2
Tiberias (Israel)	טבריה (ישראל)	49
Tifrah (Israel)	תפרח (ישראל)	1
Tikhvin (Russia)	טיחווין (רוסיה)	1
Tikrīt (Iraq)	תיכרית (עיראק)	1
Timisoara (Romania)	טימישוארה (רומניה)	4
Timrat (Israel)	תמרת (ישראל)	1
Tirana (Albania)	טירנה (אלבניה)	1
Tiraspol (Moldova)	טירספול (מולדובה)	1
Tirat Karmel (Israel)	טירת כרמל (ישראל)	1
Tirat Tsvi (Israel)	טירת צבי (ישראל)	1
Tîrgu-Lăpuș (Romania)	טירגו-לאפוס (רומניה)	2
Tirgu-Mures (Romania)	מרושושרהלי (רומניה)	1
Tiszaeszlár (Hungary)	טיסה אסלר (הונגריה)	1
Tiszafüred (Hungary)	טיסאפורד (הונגריה)	3
Tiszalök (Hungary)	טיסאליק (הונגריה)	1
Tiznit (Morocco)	טיזניט (מרוקו)	1
Tlacotalpan (Mexico)	טלקוטלפן (מקסיקו)	1
Tlemcen (Algeria)	תלמסן (אלג'יריה)	2
Tlumach (Ukraine)	טלומץ' (אוקראינה)	7
Tokyo (Japan)	טוקיו (יפן)	9
Tolcsva (Hungary)	טולצ׳בה(הונגריה)	3
Toledo (Ohio)	טולדו (אוהיו)	3
Toledo (Spain)	טולדו (ספרד)	10
Tolna (Hungary)	טולנה (הונגריה)	2
Tomashpil (Ukraine)	טומשפול (אוקראינה)	5
Tomaszów Lubelski (Poland)	טומשוב לובלסקי (פולין)	4
Tomaszów Mazowiecki (Poland)	טומשוב מזוביצק (פולין)	6
Tomsk (Russia)	טומסק (רוסיה)	5
Topeka (Kan.)	טופיקה (קנזס)	1
Topol̕čany (Slovakia)	טופולצ'ני (סלובקיה)	4
Torchyn (Lut︠s︡ʹkyĭ raĭon, Ukraine)	טורצ'ין (מחוז לוצקי, אוקראינה)	2
Törökszentmiklós (Hungary)	טרקסנטמיקלוש (הונגריה)	1
Toronto (Ont.)	טורונטו (אונטריו)	26
Toruń (Poland)	טורן (פולין)	2
Torun, Thorn	טורן (פולין : מחוז)	1
Toulon (France)	טולון (צרפת)	2
Toulouse (France)	טולוז (צרפת)	3
Tours (France)	טור (צרפת)	2
Tovačov (Czech Republic)	טובקוב (צ'כיה)	1
Tovste (Ternopilʹsʹka oblastʹ, Ukraine)	טלוסטה (אוקראינה)	5
Tovtry (Ukraine)	טויטרס (אוקראינה)	1
Trakai (Lithuania)	טראקאי (ליטא)	7
Transvaal (South Africa)	טרנסוואל (דרום אפריקה)	1
Transylvania (Romania)	טרנסילוניה (רומניה)	25
Travnik (Travnik, Bosnia and Hercegovina)	טראווניק (טראווניק, בוסניה והרצגובינה)	1
Třebíč (Czech Republic)	טרביץ' (צ'כיה)	4
Trenčín (Západoslovenský kraj, Slovakia)	טרנצ'ין (סלובקיה)	2
Trenton (N.J.)	טרנטון (ניו ג'רזי)	2
Três Corações (Brazil)	טרס קורסואס (ברזיל)	1
Třešt̕ (Czech Republic)	טרסט (צ'כיה)	2
Treuchtlingen (Germany)	טרויכטלינגן (גרמניה)	1
Trier (Germany)	טרייר (גרמניה)	3
Trieste (Italy)	טריסטה (איטליה)	14
Trikala (Greece)	טריקלה (יוון)	1
Tripoli (Libya)	טריפולי (לוב)	15
Trnava (Západoslovenský kraj, Slovakia)	טרנבה (מחוז מערב סלובקיה, סלובקיה)	2
Trondheim (Norway)	טרונדהיים (נורבגיה)	2
Troškūnai (Lithuania)	טרוסקאי (ליטא)	1
Troyes (France)	טרויש (צרפת)	2
Tryškiai (Lithuania)	טרישיק (ליטא)	1
Trzcianne (Poland)	טרעסטיני (פולין)	1
Trzebinia (Kraków, Poland)	טשבין (קרקוב, פולין)	2
Tsefat (Israel)	צפת (ישראל)	70
Tsur Hadassa (Israel)	צור הדסה (ישראל)	1
Tübingen (Germany)	טיבינגן (גרמניה)	1
Tukums (Latvia)	טוקומס (לטביה)	2
Tulcea (Romania)	טולצ'אה (רומניה)	1
Tulsa (Okla.)	טולסה (אוקלהומה)	7
Tunis (Tunisia)	תוניס (תוניסיה)	47
Tunisia	תוניסיה	26
Tupelo (Miss.)	טופלו (מיסיסיפי)	1
Turek (Poland)	טורק (פולין)	3
Turets (Belarus)	טורעץ (בלארוס)	6
Turiĭsʹk (Ukraine)	טריסק (אוקראינה)	6
Turin (Italy)	טורינו (איטליה)	136
Turka (Lʹvivsʹka oblastʹ, Ukraine)	טורקא (אוקראינה)	7
Turkey	טורקיה	18
Turkistan (Kazakhstan)	טורקיסטן (קזחסטן)	2
Turobin (Poland)	טורבין (פולין)	4
Turov (Belarus)	טורוב (בלארוס)	1
Turzysk, Turiisk	טריסק (אוקראינה)	1
Tykocin (Poland)	טיקוצין (פולין)	8
Tyrone	טיירון (צפון אירלנד)	1
Tysmenyt︠s︡i︠a︡ (Ukraine)	טיסמניץ (אוקראינה)	9
Tyszowce (Poland)	טישיויץ (פולין)	2
Ubeda (Jaén, Spain)	אובידה (חאאן, ספרד)	1
Uddevalla (Sweden)	אודוואלה (שבדיה)	1
Uherský Brod (Czech Republic)	אורסקי ברוד (צ'כיה)	6
Uherský Ostroh (Czech Republic)	אורסקי אוסטרוך (צ'כיה)	2
Uhniv (Ukraine)	היבניב (אוקראינה)	2
Újfehértó (Hungary)	רצפרטה (הונגריה)	1
Ukmerge (Lithuania)	אוקמרגה (ליטא)	16
Ukraine	אוקראינה	100
Ulʹi︠a︡novsk (Russia)	אוליאנובסק (רוסיה)	3
Ula (Belarus)	אולע (בלארוס)	1
Ulan-Udė (Russia)	אולן-אודה (רוסיה)	1
Ulashkivtsi (Ukraine)	אולאשקובצה (אוקראינה)	1
Ulm (Germany)	אולם (גרמניה)	2
Umanʹ (Ukraine)	אומן (אוקראינה)	19
Umm al-Fahm (Israel)	אום אל-פחם (ישראל)	3
Ungheni (Moldova)	אונגני (מולדובה)	1
Uniejów (Łódź, Poland)	אונייוב (פולין)	1
Uniontown (Fayette County, Pa.)	יוניונטאון (פנסילבניה)	1
United States	ארצות הברית	444
Uppsala (Sweden)	אופסלה (שבדיה)	1
Ural Mountains (Russia)	הרי האורל (רוסיה)	2
Urbino (Italy)	אורבינו (איטליה)	1
Urfa (Turkey)	אורפה (טורקיה)	1
Urim (Israel)	אורים (ישראל)	1
Uruguay	אורוגוי	11
Usafiye (Israel)	עספיא (ישראל)	7
Usha (Israel)	אושה (ישראל)	2
Ushachy (Belarus)	אושאץ (בלארוס)	1
Usingen (Germany)	אוזינגן	1
Ustrzyki Dolne (Poland)	איסטריק (פולין)	3
Ustyluh (Ukraine)	אוסטילה (אוקראינה)	1
Utena (Lithuania)	אוטין (ליטא)	3
Utrecht (Netherlands)	אוטרכט (הולנד)	3
Uzbekistan	אוזבקיסטן	1
Uzès (France)	אוזס צרפת	1
Uz︠h︡horod (Ukraine)	אונגור (אוקראינה)	9
Užpaliai (Lithuania)	אושפול (ליטה)	3
Vabalninkas (Lithuania)	ובלנינקס (ליטא)	2
Vác (Hungary)	ויצן (הונגריה)	6
Vaiguva (Lithuania)	וייגבה (ליטא)	2
Vakhnivka (Ukraine)	וחניבקה (אוקראינה)	1
Valencia (Spain)	ולנסיה (ספרד)	2
Valenciennes (France)	ואלנסיין (צרפת)	1
Valkininkai (Lithuania)	וואלקינינקאי (ליטא)	4
Valladolid (Spain)	ואיאדוליד (ספרד)	3
Valley Forge (Pa.)	ואלי פורג' (פנסילבניה)	1
Valley Stream (N.Y.)	וולי סטרים (ניו יורק)	1
Valozhyn (Belarus)	וולוז'ין (בלארוס)	15
Vancouver (B.C.)	ונקובר (בריטיש קולומביה)	5
Vannes (France)	ואן (צרפת)	2
Vanves (France)	ונו (צרפת)	1
Varaklani, Varkliany	ווארקליאן (לטביה)	1
Varkovychi (Ukraine)	ורקוביץ (אוקראינה)	1
Varna (Bulgaria)	ורנה (בולגריה)	2
Varniai (Lithuania)	וורני (ליטא)	3
Várpalota (Hungary)	ורפלוטה (הונגריה)	2
Vasilishki (Belarus)	וסילישקי (בלארוס)	3
Vaslui (Romania : Județ)	וסלוי (רומניה : מחוז)	2
Vasylʹkiv (Ukraine)	ואסילקיב (אוקראינה)	1
Vatra Dornei (Romania)	וטרה דורני (רומניה)	1
Vaŭkavysk (Belarus)	וולקוביסק (בלארוס)	7
Vejle (Denmark)	ויילה (דנמרק)	1
Velizh (Russia)	וליז' (רוסיה)	3
Velyki Mosty (Ukraine)	וילקה מוסטי (אוקראינה)	1
Venezuela	ונצואלה	1
Venice (Italy)	ונציה (איטליה)	21
Venice (Republic : To 1797)	ונציה (רפובליקה)	1
Ventspils (Latvia)	וונטספילס (לטביה)	1
Vercelli (Italy)	ורצ'לי (איטליה)	2
Verden (Germany)	פרדן (גרמניה)	1
Verdun	ורדון (צרפת)	1
Vermont	ורמונט	1
Verneuil-sur-Avre (France)	ורניי סיר אבר (צרפת)	2
Verona (Italy)	ורונה (איטליה)	4
Verpelét (Hungary)	ווערפעלעט (הונגריה)	1
Verviers (Belgium)	ורוייה (בלגיה)	1
Veszprém (Hungary)	וספרם (הונגריה)	1
Vichy (France)	וישי (צרפת)	1
Victoria	ויקטוריה	1
Vidin (Bulgaria)	וידין (בולגריה)	2
Vidzy (Belarus)	וידז (בלארוס)	3
Viekšniai (Lithuania)	ווקסנא (ליטא)	9
Vienna (Austria)	וינה (אוסטריה)	191
Viernheim (Germany)	פירנהיים (גרמניה)	1
Vietnam	ויטנם	1
Viļaka (Latvia)	וילאקה (לטביה)	1
Vileĭka (Minskai︠a︡ voblastsʹ, Belarus)	ווילייקה (מחוז מינסק, בלארוס)	4
Vilijampolė (Kaunas, Lithuania)	ויליאמפולה (קובנה, ליטא)	6
Vilkaviškis (Lithuania)	וילקובישק (ליטא)	18
Vilna, Lithuania	וילנה (ליטא)	1
Vilnius (Lithuania)	וילנה (ליטא)	261
Vinnyt︠s︡ʹka oblastʹ (Ukraine)	מחוז ויניצה (אוקראינה)	2
Vinnyt︠s︡i︠a︡ (Ukraine)	ויניצה (אוקראינה)	5
Virbalis (Lithuania)	וירבלן (ליטא)	3
Virginia	וירג'יניה	4
Vișeu de Sus (Romania)	וישאו דה סוס (רומניה)	7
Vishneva (Minskai︠a︡ voblastsʹ, Belarus)	וישנבה (בלארוס)	2
Vištytis (Lithuania)	ווישטינץ (ליטא)	7
Vitsebsk (Belarus)	ויטבסק (בלארוס)	11
Vitsebskai︠a︡ voblastsʹ (Belarus)	מחוז ויטבסק (בלארוס)	15
Vladimir (Vladimirskai︠a︡ oblastʹ, Russia)	ולדימיר (מחוז ולדימיר, רוסיה)	3
Vladivostok (Russia)	ולדיווסטוק (רוסיה)	1
Voghera (Italy)	ווגרה (איטליה)	1
Volgograd (Russia)	וולגוגרד (רוסיה)	1
Volhynia (Ukraine)	ווהלין (אוקראינה)	6
Volkovisk	וילקובישק (ליטא)	2
Volodymyr-Volynsʹkyĭ (Ukraine)	וולודימיר-ולינסקי (אוקראינה)	1
Vologda (Russia)	וולוגדה (רוסיה)	2
Volos (Greece)	וולוס (יוון)	1
Volynsʹka oblastʹ (Ukraine)	מחוז ווהלין (אוקראינה)	3
Voronezh (Russia)	וורונז' (רוסיה)	3
Võru (Estonia)	וורו (אסטוניה)	1
Vouziers (France)	ווזיר (צרפת)	1
Vrbové (Slovakia)	ורבובה (סלובקיה)	3
Vuzlove (Zakarpatsʹka oblastʹ, Ukraine)	ווזלובה (מחוז זקרפטיה, אוקראינה)	2
Vyborg (Russia)	וויבורג (רוסיה)	1
Vylok (Ukraine)	וילוק (אוקראינה)	2
Vynohradiv (Ukraine)	וינוגרדוב (אוקראינה)	3
Vyshnivet︠s︡ʹ (Ukraine)	ווישניביץ (אוקראינה)	1
Vysokaye (Belarus)	וויסאקי (בלארוס)	1
Vyz︠h︡nyt︠s︡i︠a︡ (Ukraine)	ויז'ניץ (אוקראינה)	11
Waco (Tex.)	וייקו (טקסס)	1
Wadowice (Poland)	ודוביצה (פולין)	1
Wakefield	ווייקפילד (אנגליה)	1
Wakefield (England)	ווייקפילד (אנגליה)	1
Wałbrzych (Poland)	וולברז'יץ' (פולין)	1
Wales	ויילס	3
Wales, South	ויילס הדרומית	1
Wallerstein (Germany)	וולרשטיין (גרמניה)	1
Walton-on-Thames (England)	וולטון-על-התמזה (אנגליה)	1
Wangen im Allgäu (Germany)	וונגן אם אלגוו (גרמניה)	1
Warka (Poland)	וורקה (פולין)	2
Warsaw (Poland)	ורשה (פולין)	337
Warta (Poland)	וארטה (פולין)	3
Warwickshire (England)	וורוויקשייר (אנגליה)	1
Washington (D.C.)	ושינגטון (די. סי.)	19
Washington Heights (New York, N.Y.)	וושינגטון הייטס (ניו יורק, ניו יורק)	1
Wasilków (Poland)	וסילקוב (פולין)	3
Watertown (N.Y.)	ווטרטאון (ניו יורק)	1
Węgrów (Poland)	ונגרוב (פולין)	1
Weikersheim (Germany)	ווייקרסהיים (גרמניה)	1
Weissenfels (Germany)	וייסנפלס (גרמניה)	1
Welwyn Garden City (England)	ולוין גרדן סיטי (אנגליה)	1
Wernigerode (Germany)	וורניגרודה (גרמניה)	1
Wesel (Germany)	ווסל (גרמניה)	1
West Virginia	וירגיניה המערבית	4
Western Australia	אוסטרליה המערבית	9
Westminster (London, England)	ווסטמינסטר (לונדון, אנגליה)	2
Westphalia (Germany)	וסטפליה (גרמניה)	1
Wexford (Ireland)	ווקספורד (אירלנד)	1
Weyburn (Sask.)	וייבורן (ססקצ'ואן)	1
White Plains	וייט פליינס (ניו יורק)	2
White Plains (N.Y.)	וייט פליינס (ניו יורק)	1
Whittier (Calif.)	וויטיאר (קליפורניה)	1
Wichita (Kan.)	ויצ'יטה (קנזס)	1
Wieliczka (Poland)	ויליצ'קה (פולין)	5
Wiener Neustadt (Austria)	נוישטט (אוסטריה)	2
Wieruszów (Poland)	וירושוב (פולין)	3
Wiesbaden (Germany)	וויסבאדן (גרמניה)	4
Wilkes-Barre (Pa.)	ווילקס-באר (פנסילבניה)	1
Williamsburg (New York, N.Y.)	וילימסבורג (ניו יורק, נ.י. : שכונה)	2
Williamsburgh, Brooklyn	וילימסבורג (ניו יורק, נ.י. : שכונה)	1
Wilmington (N.C.)	ווילמינגטון (צפון קרולינה)	2
Winchester (England)	וינצ'סטר (אנגליה)	2
Winnipeg (Man.)	וויניפג (מניטובה)	3
Winston-Salem (N.C.)	ווינסטון-סיילם (צפון קרולינה)	1
Winterthur (Switzerland)	ווינטרתור (שווייץ)	1
Wisconsin	ויסקונסין	10
Wizna (Poland)	ויזנה (פולין)	2
Włocławek (Poland)	ולוצלאווק (פולין)	17
Włoszczowa (Poland)	וולושצובה (פולין)	1
Wodzisław (Poland)	וודז'יסלאב (פולין)	4
Wohyń (Poland)	ווהין (פולין)	2
Wojnicz (Poland)	וויניץ (פולין)	1
Wola (Warsaw, Poland)	וולה (ורשה, פולין)	2
Wolbórz (Poland)	וולברז (פולין)	1
Worcester (Mass.)	ווסטר (מסצ'וסטס)	2
Worms (Germany)	וורמס (גרמניה)	6
Wrocław (Poland)	ורוצלב (פולין)	49
Wronki (Piła, Poland)	ורונקי (פולין)	3
Września (Województwo Wielkopolskie, Poland)	וז'אסנייה (פולין)	1
Wuppertal (Germany)	וופרטל (גרמניה)	2
Württemberg (Germany)	ווירטמברג	2
Würzburg (Germany)	וירצבורג (גרמניה)	8
Wyoming	ויומינג	1
Wysokie Mazowieckie (Poland)	ויסוקה מזוביצק (פולין)	2
Wyszków (Poland)	וישקוב (פולין)	1
Wyszogród (Poland)	וישוגרוד (פולין)	3
Yagur (Israel)	יגור (קבוץ)	14
Yarmolyntsi (Ukraine)	ירמליניץ (אוקראינה)	3
Yas'ur (Galilee) (Israel)	יסעור (גליל) (ישראל)	2
Yavne (Israel)	יבנה (ישראל)	3
Yavne'el (Israel)	יבנאל (ישראל)	7
Yazd (Iran)	יזד (איראן)	2
Yazlovets (Ukraine)	יזלוביץ (אוקראינה)	1
Yehud (Israel)	יהוד (ישראל)	2
Yemen (Arab Republic)	תימן (רפובליקה ערבית)	1
Yemen (Republic)	תימן (רפובליקה)	21
Yerevan (Armenia)	ירוואן (ארמניה)	2
Yeruham (Israel)	ירוחם (ישראל)	2
Yesud Hama'ala (Israel)	יסוד המעלה (ישראל)	2
Yifat (Israel)	יפעת (ישראל)	1
Yirka (Israel)	ירכא (ישראל)	1
Yodfat (Israel)	יודפת (ישראל)	1
Yokne'am (Israel)	יקנעם (מושבה) (ישראל)	1
Yonkers (N.Y.)	יונקרס (ניו יורק)	1
Yonne (France)	יון (צרפת)	1
York (England)	יורק (אנגליה)	1
Yorkshire	יורקשייר (אנגליה)	1
Yorkshire (England)	יורקשייר (אנגליה)	1
Yugoslavia	יוגוסלביה	18
Yuval (Israel)	יובל (ישראל)	1
Żabno (Województwo Małopolskie, Poland)	ז'אבנו (פולין)	5
Zabolotiv (Ukraine)	זבלוטוב (אוקראינה)	6
Zacatecas (Zacatecas, Mexico)	סקטקס (סקטקס, מקסיקו)	1
Žagarė (Lithuania)	זאגר (ליטא)	20
Zagórów (Poland)	זאגורוב (פולין)	1
Zagórz (Poland)	זגורש	1
Zagreb (Croatia)	זגרב (קרואטיה)	8
Zakhu (Iraq)	זאכו (עיראק)	1
Zakroczym (Poland)	זאקרוצ'ים (פולין)	1
Zaleshchiki (Ukraine)	זלישצ'יק (אוקראינה)	2
Zalishchyky (Ukraine)	זאלישציקי (אוקראינה)	2
Zaliztsi (Ukraine)	זלוזיץ (אוקראינה)	3
Zambrów (Poland)	זאמברוב	4
Zamora (Spain)	זמורה (ספרד)	4
Zamość (Poland)	זמושץ' (פולין)	34
Zaniemyśl (Poland)	זאנדע מישלע (פולין)	1
Zaporizhia (Ukraine)	זפורוז'יה (אוקראינה)	1
Zaragoza (Spain)	סרגוסה (ספרד)	2
Zarichanka (Ukraine)	לנצקורון (אוקראינה)	2
Żarki (Poland)	ז'רקי (פולין)	3
Zarzir (Israel)	זרזיר (ישראל)	1
Žasliai (Lithuania)	זאסלע (ליטא)	4
Žatec (Ústecký kraj, Czech Republic)	ז'אטץ (מחוז אוטצקי, צ'כיה)	2
Zawalów (Poland)	זאוואלוב (פולין)	2
Zawiercie (Poland)	זבירציה (פולין)	6
Zāwiyah (Libya)	א-זאווייה (לוב)	1
Zbaraż (Poland)	זבאריזש (פולין)	1
Zboriv (Ukraine)	זבורוב (אוקראינה)	12
Zdolbunow (Ukraine)	זדולבונוב (אוקראינה)	2
Zduńska Wola (Poland)	זדונסקה-וולה (פולין)	5
Žeimelis (Lithuania)	זוימל (ליטא)	1
Zėlʹva (Belarus)	זלוה (בלארוס)	1
Zelechow (Poland)	ז'ליחוב (פולין)	4
Zelów (Poland)	זלוב (פולין)	1
Zembin (Belarus)	זמבין (בלארוס)	1
Zemun (Belgrade, Serbia)	זמון (בלגרד, סרביה)	1
Zetan (Israel)	זיתן (ישראל)	1
Zgierz (Poland)	זגירז' (פולין)	7
Zguriţa (Moldova)	זגוריצה (מולדובה)	1
Zhashkiv (Ukraine)	ז'שקוב (אוקראינה)	2
Zhejiang Sheng (China)	ג'ג'יאנג (סין : מחוז)	2
Zheludok (Belarus)	ז'לודוק (בלארוס)	2
Zhmerynka (Ukraine)	ז'מרינקה (אוקראינה)	2
Z︠H︡uravno (Ukraine)	ז'ורבנו (אוקראינה)	2
Z︠H︡vanet︠s︡' (Ukraine)	זוואנץ (אוקראינה)	2
Zhytomyr (Ukraine)	זיטומיר (אוקראינה)	24
Židikai (Lithuania)	זידיקאי (ליטא)	1
Žiežmariai (Lithuania)	ז'זמר (ליטא)	1
Zikhron Ya'akov (Israel)	זכרון יעקב (ישראל)	19
Zikim (Israel)	זיקים (ישראל)	1
Zimbabwe	זימבבואה	4
Zittau (Germany)	ציטאו (גרמניה)	1
Znojmo (Czech Republic)	זנוימו (צ'כיה)	2
Żółkiew (Poland)	ז'ולקייב (פולין)	20
Żółkiewka (Poland)	ז'ולקבקה (פולין)	1
Zolochiv (Lʹvivsʹka oblastʹ, Ukraine)	זולוצ'יב (מחוז לביב, אוקראינה)	12
Zolochiv, Ukraine	זולוצ'יב (מחוז חרקיב, אוקראינה)	1
Zurich (Switzerland)	ציריך (שווייץ)	11
Zvenyhorodka (Ukraine)	זבניגורודקה (אוקראינה)	4
Zwickau (Germany)	צוויקאו (גרמניה)	1
Zwoleń (Radom, Poland)	זוואלין (ראדום, פולין)	3
Zwolle (Netherlands)	זוולה (הולנד)	2
Żychlin (Konin, Poland)	זיכלין (קונין, פולין)	1
Żyrardów (Poland)	ז'ירדוב (פולין)	1
