deathplaces appears as 1	primary heb full in Kima	times
Aachen (Germany)	אאכן (גרמניה)	1
Aarau (Switzerland)	אראו (שווייץ)	2
Aberdeen (Scotland)	אברדין (סקוטלנד)	1
Accra (Ghana)	אקרה (גאנה)	1
Acre (Israel)	עכו (ישראל)	9
Aden (Yemen)	עדן (תימן)	2
Afek (Israel)	אפק (ישראל)	1
Afikim (Israel)	אפיקים (ישראל)	9
Afula (Israel)	עפולה (ישראל)	4
Aix-les-Bains (France)	אקס לה בן (צרפת)	1
Alba Iulia (Romania)	אלבה יוליה (רומניה)	1
Albany (N.Y.)	אלבני (ניו יורק)	1
Albertirsa (Hungary)	אלברטירשה (הונגריה)	1
Albuquerque (N.M.)	אלבוקרקי (ניו מקסיקו)	1
Aleksandrów Łodzki (Poland)	אלכסנדר (פולין)	4
Aleppo (Syria)	חלב (סוריה)	45
Alexandria (Egypt)	אלכסנדריה (מצרים)	4
Algiers (Algeria)	אלג'יר (אלג'יריה)	10
Allon Shevut (West Bank)	אלון שבות (גדה מערבית)	1
Alonim (Israel)	אלונים (ישראל)	3
Altona (Germany)	אלטונה (גרמניה)	3
Alytus (Lithuania)	אליטא (ליטא)	1
Amagansett (N.Y.)	אמגנסט (ניו יורק)	1
Amherst (Mass.)	אמהרסט (מסצ'וסטס)	2
Amiens (France)	אמיין (צרפת)	1
Amsterdam (Netherlands)	אמסטרדם (הולנד)	54
Ancona (Italy)	אנקונה (איטליה)	6
Angers (France)	אנז'ה (צרפת)	1
Annecy (France)	אנסי (צרפת)	1
Annopol (Poland)	אנופול (פולין)	1
Ansbach (Mittelfranken, Germany)	אנסבך (גרמניה)	3
Antibes (France)	אנטיב (צרפת)	1
Antopalʹ (Belarus)	אנטופול (בלארוס)	1
Antwerp (Belgium)	אנטורפן (בלגיה)	9
Apeldoorn (Netherlands)	אפלדורן (הולנד)	1
Arad (Romania)	ארד (רומניה)	2
Arévalo (Spain)	ארבאלו (ספרד)	1
Argenta (Italy)	אריינטו (איטליה)	2
Argentina	ארגנטינה	2
Arizona	אריזונה	1
Arles (France)	ארל (צרפת)	1
Arta (Greece)	ארטה (יוון)	2
Artemivsʹk (Ukraine)	ארטמיבסק (אוקראינה)	2
Aschaffenburg (Germany)	אשפנבורג (גרמניה)	1
Ascona (Switzerland)	אסקונה (שווייץ)	1
Ashdod (Israel)	אשדוד (ישראל)	3
Ashdot Yaakov (Israel)	אשדות יעקב (ישראל)	7
Ashkelon (Israel)	אשקלון (ישראל)	4
Aspen (Colo.)	אספן (קולורדו)	1
Athens (Greece)	אתונה (יוון)	11
Atlanta (Ga.)	אטלנטה (ג'ורג'יה)	3
Atlit (Israel)	עתלית (ישראל)	2
Auckland (N.Z.)	אוקלנד (ניו זילנד)	1
Augsburg (Germany)	אוגסבורג (גרמניה)	1
Austin (Tex.)	אוסטין (טקסס)	1
Australia	אוסטרליה	3
Austria	אוסטריה	3
Auvers-sur-Oise (France)	אובר-סור-אואז (צרפת)	1
Avignon (France)	אויניון (צרפת)	1
Avihayil (Israel)	אביחיל (ישראל)	3
Aydın (Aydın İli, Turkey)	איידין (מחוז איידין, טורקיה)	1
Ayyelet Hashahar (Israel)	איילת השחר (ישראל)	5
Babruĭsk (Belarus)	בוברויסק (בלארוס)	4
Bacău (Romania)	בקאו (רומניה)	3
Bačko Petrovo Selo (Serbia)	באצ'קו פטרובו סלו (סרביה)	1
Bad Ems (Germany)	באד אמס (גרמניה)	1
Bad Godesberg (Bonn, Germany)	בד גודסברג (גרמניה)	1
Bad Kissingen (Germany)	באד קיסינגן (גרמניה)	2
Bad Nauheim (Germany)	באד נאוהיים (גרמניה)	1
Bad Reichenhall (Germany)	באד רייכנהאל (גרמניה)	1
Baden (Austria)	בדן (אוסטריה)	3
Baden-Baden (Germany)	בדן-בדן (גרמניה)	3
Baghdad (Iraq)	בגדאד (עיראק)	24
Baiersdorf (Mittelfrankenstadt, Germany)	באירסדורך (גרמניה)	1
Baja (Hungary)	ביאה (הונגריה)	1
Balassagyarmat (Hungary)	בלשג'רמט (הונגריה)	5
Balmazújváros (Hungary)	באלמזוייבארוש (הונגריה)	2
Baltimore (Md.)	בולטימור (מרילנד)	18
Bamberg (Germany)	במברג (גרמניה)	1
Banbury (Oxfordshire, England)	בנברי (אוקספורדשייר, אנגליה)	1
Banghāzī (Libya)	בנגאזי (לוב)	2
Bangkok (Thailand)	בנגקוק (תאילנד)	1
Bánovce nad Bebravou (Slovakia)	באנוביצה נאד ברבראבו (סלובקיה)	1
Banská Bystrica (Slovakia)	בנסקה ביסטריצה (סלובקיה)	2
Bar'am (Israel)	ברעם (ישראל)	1
Baranavichy (Belarus)	ברנוביץ' (בלארוס)	2
Baranowicze (Poland)	ברנוביץ (פולין)	1
Barbados	ברבדוס	1
Barcelona (Spain)	ברצלונה (ספרד)	6
Basel (Switzerland)	בזל (שווייץ)	7
Basel-Stadt (Switzerland)	בזל-שטאדט (שווייץ)	1
Bat Hefer (Israel)	בת חפר (ישראל)	1
Bat Yam (Israel)	בת ים (ישראל)	11
Bath (England)	באת' (אנגליה)	1
Bátorove Kosihy (Slovakia)	בטורקס (סלובקיה)	1
Bauska (Latvia)	באוסקה (לטביה)	3
Bavaria (Germany)	בוואריה (גרמניה)	2
Bay Shore (N.Y.)	ביי שור (ניו יורק)	1
Bayonne (France)	ביון (צרפת)	1
Bayreuth (Germany)	ביירוית (גרמניה)	2
Be'er Ya'akov (Israel)	באר יעקב (ישראל)	1
Beclean (Romania)	בקליאן (רומניה)	2
Bedford Hills (N.Y.)	בדפורד הילס (ניו יורק)	1
Bedfordshire (England)	בדפורדשייר (אנגליה)	1
Będzin (Poland)	בנדין (פולין)	4
Beersheba (Israel)	באר שבע (ישראל)	7
Beijing (China)	בייג'ינג (סין)	4
Beirut (Lebanon)	בירות (לבנון)	8
Békéscsaba (Hungary)	בקשצ'אבה (הונגריה)	1
Bel Air (Los Angeles, Calif.)	בל אייר (לוס אנג'לס, קליפורניה)	1
Belarus	בלארוס	3
Bełchatów (Poland)	בלכטוב (פולין)	1
Belgium	בלגיה	1
Belgrade (Serbia)	בלגרד (סרביה)	6
Belz (Ukraine)	בלז (אוקראינה)	2
Bender (Moldova)	בנדרי (מולדובה)	1
Bene Brak (Israel)	בני ברק (ישראל)	71
Berchtesgaden (Germany)	ברכטסגאדן (גרמניה)	1
Berdychiv (Ukraine)	ברדיצ'ב (אוקראינה)	9
Berettyóújfalu (Hungary)	ברטואויפלו (הונגריה)	1
Berez︠h︡any (Ukraine)	בז'ז'ני (אוקראינה)	6
Berezyne (Odesʹka oblastʹ, Ukraine)	ברזנה (מחוז אודסק, אוקראינה)	1
Bergama (Turkey)	פרגמון (טורקיה)	1
Bergen Belsen (Germany)	ברגן בלזן (גרמניה)	3
Berkeley (Calif.)	ברקלי (קליפורניה)	7
Berlin (Germany)	ברלין (גרמניה)	146
Bern (Switzerland)	ברן (שווייץ)	4
Bershadʹ (Ukraine)	ברשד (אוקראינה)	1
Bet Alfa (Israel)	בית אלפא (ישראל)	8
Bet Gamli'el (Israel)	בית גמליאל (ישראל)	1
Bet Hashitta (Israel)	בית השיטה (ישראל)	8
Bet Keshet (Israel)	בית קשת (ישראל)	4
Bet Nekofa (Israel)	בית נקופה (ישראל)	1
Bet Oren (Israel)	בית אורן (ישראל)	2
Bet Shemesh (Israel)	בית שמש (ישראל)	1
Bet Yehoshu'a (Israel)	בית יהושוע (ישראל)	1
Bet Yits'hak (Israel)	בית יצחק (ישראל)	1
Bet Zera (Israel)	בית זרע (ישראל)	1
Bethesda (Md.)	בתסדה (מרילנד)	1
Bethlehem (West Bank)	בית לחם (גדה מערבית)	1
Beuthen (Germany)	בויטן (גרמניה)	2
Beverly Hills (Calif.)	בוורלי הילס (קליפורניה)	7
Beʼerot Yitsḥaḳ (Israel)	בארות יצחק (ישראל)	1
Białobrzegi (Radom, Poland)	בילובז'יג (פולין)	1
Białystok (Poland)	ביאליסטוק (פולין)	51
Biebrich (Wiesbaden, Germany)	ביבריך (ויסבאדן, גרמניה)	2
Biel (Bern, Switzerland)	ביל (ברן, שווייץ)	1
Bielsk Podlaski (Poland)	בילסק (פולין)	1
Bielsko-Biała (Poland)	ביליץ בילה (פולין)	3
Bila T︠S︡erkva (Ukraine)	בילה צרקווה (אוקראינה)	1
Bilohirsʹk (Ukraine)	בילוהירסק (אוקראינה)	1
Bingen (Germany)	בינגן (גרמניה)	1
Bingen (Rhineland-Palatinate, Germany)	בינגן (ריינלנד-פאלץ, גרמניה)	1
Binyamina (Israel)	בנימינה (ישראל)	1
Birobidzhan (Russia)	בירוביג'אן (רוסיה)	1
Biržai (Lithuania)	בירזאי (ליטא)	2
Bishop's Stortford (England)	בישופס סטורטפורד (אנגליה)	1
Biskupice (Poland)	בישקופיץ (פולין)	1
Blackburn (England)	בלקבורן (אנגליה)	2
Blankenese (Hamburg, Germany)	בלנקנזה (המבורג, גרמניה)	1
Bloemfontein (South Africa)	בלומפונטיין (דרום אפריקה)	1
Bobowa (Poland)	בובוב (פולין)	1
Bochnia (Poland)	בוכניה (פולין)	1
Bockenheim (Frankfurt am Main, Germany)	בוקנהיים (פרנקפורט, גרמניה)	1
Bodenwerder (Germany)	באדענווערדער (גרמניה)	1
Bodrogkeresztúr (Hungary)	קרסטיר (הונגריה)	1
Bogotá (Colombia)	בוגוטה (קולומביה)	1
Bohemia (Czech Republic)	בוהמיה (צ'כיה)	1
Bohorodchany (Ukraine)	בוהורודצ'ני (אוקראינה)	3
Boise (Idaho)	בויזי (איידהו)	1
Bolekhiv (Ukraine)	בוליחוב (אוקראינה)	7
Bolhrad (Ukraine)	בולהרד (אוקראינה)	1
Bologna (Italy)	בולוניה (איטליה)	3
Bolzano (Italy : Province)	בולצנו (איטליה : מחוז)	1
Bonn (Germany)	בון (גרמניה)	6
Bonyhád (Hungary)	בוניהד (הונגריה)	8
Bordeaux (Aquitaine, France)	בורדו (צרפת)	1
Bordighera (Italy)	בורדיגרה (איטליה)	1
Borshchiv (Ternopilʹsʹka oblastʹ, Ukraine)	בורשניב (טרנופיל, אוקראינה)	3
Boryslav (Ukraine)	בוריסלב (אוקראינה)	3
Borzna (Ukraine)	בורזנה (אוקראינה)	1
Boskovice (Czech Republic)	בוסקוביץ (צ'כיה)	3
Boston (Mass.)	בוסטון (מסצ'וסטס)	29
Botosani (Romania)	בוטושן (רומניה)	5
Bougival (France)	בוגיבל (צרפת)	2
Boulogne-sur-Mer (France)	בולון-סור-מר (צרפת)	2
Bound Brook (N.J.)	באונד ברוק (ניו ג'רזי)	1
Bournemouth (England)	בורנמות (אנגליה)	2
Brahin (Belarus)	בראהין (בלארוס)	1
Brailiv (Ukraine)	ברהילוב (אוקראינה)	1
Brańsk (Poland)	ברינסק (פולין)	2
Braslaŭ (Belarus)	בראסלאו (בלארוס)	2
Bratislava (Slovakia)	ברטיסלבה (סלובקיה)	38
Braunschweig (Germany)	בראונשווייג (גרמניה)	3
Brazil	ברזיל	3
Bregenz (Austria)	ברגנץ (אוסטריה)	1
Breisach am Rhein (Germany)	ברייסך אם ריין (גרמניה)	1
Bremen (Germany)	ברמן (גרמניה)	2
Bridgeport (Conn.)	ברידג'פורט (קונטיקט)	1
Brighton (England)	ברייטון (אנגליה)	9
Brilon (Germany)	ברילון (גרמניה)	1
Bristol (England)	בריסטול (אנגליה)	1
Brody (Ukraine)	ברודי (אוקראינה)	54
Brok (Ostrołęka, Poland)	ברוק (אוסטרולקה, פולין)	1
Bronx (New York, N.Y.)	ברונקס (ניו יורק, ניו יורק)	6
Brookline (Mass.)	ברוקליין (מסצ'וסטס)	4
Brooklyn (New York, N.Y.)	ברוקלין (ניו יורק, נ.י.)	18
Brussels (Belgium)	בריסל (בלגיה)	11
Brzeg Dolny (Poland)	ברזג דולני (פולין)	1
Brześć Kujawski (Poland)	בז'שץ' קויאוסקי (פולין)	1
Brześć Litewski (Poland)	ברסט ליטובסק (פולין)	10
Brzesko (Poland)	בריגל בז'סקו (פולין)	2
Buchach (Ukraine)	בוצ'ץ' (אוקראינה)	10
Bucharest (Romania)	בוקרסט (רומניה)	25
Buda (Hungary)	בודה (הונגריה)	3
Budapest (Hungary)	בודפסט (הונגריה)	63
Buenos Aires (Argentina)	בואנוס איירס (ארגנטינה)	89
Buffalo (N.Y.)	באפלו (ניו יורק)	5
Buhusi (Romania)	בוחוש (רומניה)	1
Bukachivtsi (Ukraine)	בוקצ'ביץ (אוקראינה)	3
Bukhoro (Uzbekistan)	בוכרה (אוזבקיסטן)	1
Bukowsko (Poland)	בוקובסק (פולין)	1
Bulgaria	בולגריה	1
Burdujeni (Suceava, Romania)	בורדוזשן (סוצ'אבה, רומניה)	3
Burgenland (Austria)	בורגנלנד (אוסטריה)	2
Burgeta (Israel)	בורגתה (ישראל)	1
Burshtyn (Ukraine)	בורשטין (אוקראינה)	1
Bury St. Edmunds (England)	ברי סנט אדמונדס (אנגליה)	1
Busʹk (Ukraine)	בוסק (אוקראינה)	3
Bushtyna (Ukraine)	בושטינה (אוקראינה)	1
Bussum (Netherlands)	בוסום (הולנד)	1
Butrimonys (Lithuania)	בוטרימוניס (ליטא)	1
Byaroza (Belarus)	ברעזי (בלארוס)	1
Bychawa (Poland)	ביחוה (פולין)	1
Bytom (Poland)	ביטום (פולין)	1
Caen (France)	קן (צרפת)	1
Caesarea (Israel)	קיסריה (ישראל)	1
Cahors (France)	קהור (צרפת)	1
Cairo (Egypt)	קהיר (מצרים)	27
Calcutta (India)	כלכתה (הודו)	3
California	קליפורניה	13
Cambrai (France)	קמברה	1
Cambridge (England)	קמברידג' (אנגליה)	16
Cambridge (Mass.)	קמברידג' (מסצ'וסטס)	3
Camden (N.J.)	קמדן (ניו ג'רזי)	1
Cannes (France)	קאן (צרפת)	6
Cape Town (South Africa)	קייפטאון (דרום אפריקה)	5
Cardiff (Wales)	קארדיף (ויילס)	1
Carei (Romania)	קרולה (רומניה)	2
Casablanca (Morocco)	קזבלנקה (מרוקו)	3
Casale Monferrato (Italy)	קזאלה מונפראטו (איטליה)	4
Castellazzo Bormida (Italy)	קסטלצו בורמידה (איטליה)	1
Catalonia (Spain)	קטלוניה (ספרד)	1
Catskill Mountains (N.Y.)	הרי קטסקיל (ניו יורק)	1
Cayman Islands	איי קיימן	1
Cento (Italy)	צ'נטו (איטליה)	1
Certaldo (Italy)	סרטלדו (איטליה)	1
Chalkis (Extinct city)	כלקיס (עיר קדומה)	1
Chamonix-Mont-Blanc (France)	שאמוני-מון-בלאן (צרפת)	1
Chania (Greece)	חאניה (יוון)	1
Chantilly (France)	שנטילי (צרפת)	1
Charleston (S.C.)	צ'רלסטון (דרום קרולינה)	3
Charlotte (N.C.)	שרלוט (צפון קרולינה)	1
Charlottenburg (Berlin, Germany)	שרלוטנבורג (ברלין, גרמניה)	2
Chashniki (Belarus)	צ'שניקי (בלארוס)	2
Chattanooga (Tenn.)	צ'טנוגה (טנסי)	2
Chechelnyk (Ukraine)	טשטשלניק (אוקראינה)	1
Chęiny (Województwo Święokrzyskie, Poland)	חנטשין (קילצה, פולין)	2
Chelsea (London, England)	צ'לסי (לונדון, אנגליה)	1
Chelsea (Mass.)	צ'לסי (מסצ'וסטס)	1
Chengdu (China)	צ'נגדו (סין)	1
Cher (France)	שר (צרפת)	1
Cherkasy (Ukraine)	צ'רקאסי (אוקראינה)	1
Chernihiv (Ukraine)	צ'רנייב (אוקראינה)	1
Chernivt︠s︡i (Ukraine)	צ'רנוביץ (אוקראינה)	18
Chervonohrad (Ukraine)	קריסנפוליו (אוקראינה)	1
Chevy Chase (Md.)	שווי צ'ייס (מרילנד)	2
Chicago (Ill.)	שיקגו (אילינוי)	63
Chichester (England)	צ'יצ'סטר (אנגליה)	1
Chișinău (Moldova)	קישינב (מולדובה)	8
Chornobylʹ (Ukraine)	צ'רנוביל (אוקראינה)	1
Chortkiv (Ukraine)	צ'ורטקוב (אוקראינה)	3
Chrzanów (Poland)	כשנוב (פולין)	4
Chufut-Kale (Ukraine)	צ'ופוט קלעה (אוקראינה)	2
Ciechanów (Poland)	צ'כנוב (פולין)	3
Ciechanowiec (Poland)	ציחנוביץ (פולין)	1
Cieszanow (Poland)	צישינוב (פולין)	1
Cieszyn (Województwo Śląskie, Poland)	צ'שין (מחוז שלזיה, פולין)	1
Cimpulung Moldovenesc (Romania)	קימפולונג (רומניה)	1
Cincinnati (Ohio)	סינסינטי (אוהיו)	16
Civitavecchia (Italy)	ציביטבקיה (איטליה)	1
Clamart (France)	קלמרט (צרפת)	1
Cleveland (Ohio)	קליבלנד (אוהיו)	14
Cluj-Napoca (Romania)	קלוז'-נאפוקה (רומניה)	6
Coburg (Germany)	קובורג (גרמניה)	1
Colmar (France)	קולמאר (צרפת)	1
Cologne (Germany)	קלן (גרמניה)	8
Columbus (Ohio)	קולומבוס (אוהיו)	2
Como (Italy)	קומו	1
Compiègne (France)	קומפיין (צרפת)	1
Concord (Mass.)	קונקורד (מסצ'וסטס)	1
Connecticut	קונטיקט	6
Constanţa (Romania)	קונסטנצה (רומניה)	1
Constantine (Algeria)	קונסטנטין (אלג'יריה)	1
Copenhagen (Denmark)	קופנהגן (דנמרק)	15
Córdoba (Argentina)	קורדובה (ארגנטינה)	1
Córdoba (Spain)	קורדובה (ספרד)	1
Cork (Ireland)	קורק (אירלנד)	1
Cornwall (Conn.)	קורנוול (קונטיקט)	1
Cornwall (England : County)	קורנוול (אנגליה : מחוז)	1
Courbevoie (France)	קורבבוי (צרפת)	1
Coventry (England)	קובנטרי (אנגליה)	1
Csenger (Hungary)	צ'נגר (הונגריה)	3
Cuernavaca (Mexico)	קוורנבקה (מקסיקו)	2
Curitiba (Brazil)	קוריטיבה (ברזיל)	1
Czarnków (Poland)	צרניקאו (פולין)	1
Częstochowa (Poland)	צ'נסטוחובה (פולין)	5
Da̜bie (Województwo Wielkopolskie, Poland)	דומביה (מחוז פולין גדול, פולין)	1
Dąbrowa Białostocka (Poland)	דומברובה ביאלוסטוקה (פולין)	1
Dabrowa Gornicza (Poland)	דומברובה גורניצ'ה (פולין)	2
Dąbrowa Tarnowska (Poland : Powiat)	דומברובה טרנובסקה (פולין : מחוז)	1
Dachau (Germany)	דכאו (גרמניה)	1
Dafna (Israel)	דפנה (ישראל)	8
Dakar (Senegal)	דקר (סנגל)	1
Daliyya (Israel)	דליה (ישראל)	1
Dallas (Tex.)	דאלאס (טקסס)	3
Dalton (Israel)	דלתון (ישראל)	1
Damascus (Syria)	דמשק (סוריה)	10
Dan (Israel)	דן (ישראל)	1
Danbury (Conn.)	דנברי (קונטיקט)	2
Danzig (Germany)	דנציג (גרמניה)	1
Dar es Salaam (Tanzania)	דאר א-סלאם	1
Darabani (Romania)	דרבן (רומניה)	1
Daugavpils (Latvia)	דוינסק (לטביה)	5
Daŭhinava (Minskai︠a︡ voblastsʹ, Belarus)	דלהינוב (מחוז מינסק, בלארוס)	1
Davos (Switzerland)	דאבוס (שווייץ)	1
Davyd-Haradok (Belarus)	דויד הורודוק (בלארוס)	2
Dayton (Ohio)	דייטון (אוהיו)	2
Debrecen (Hungary)	דברצן (הונגריה)	1
Deganya Alef (Israel)	דגניה א' (ישראל)	11
Deganya Bet (Israel)	דגניה ב' (ישראל)	4
Deià (Spain)	דייה (ספרד)	1
Dej (Romania)	דז' (רומניה)	4
Delmenhorst (Germany)	דלמנהורסט (גרמניה)	1
Denia (Spain)	דניה (ספרד)	1
Denmark	דנמרק	1
Denver (Colo.)	דנוור (קולורדו)	3
Dessau (Halle, Germany)	דסאו (הלה, גרמניה)	7
Detroit (Mich.)	דטרויט (מישיגן)	7
Deutschkreutz (Austria)	דויטש קרויץ (אוסטריה)	2
Deva (Romania)	דוה (רומניה)	1
Dhamār (Yemen)	דמאר (תימן)	1
Dimona (Israel)	דימונה (ישראל)	1
Domažlice (Czech Republic)	דומזליצ'ה (צ'כיה)	1
Domínguez (Entre Ríos, Argentina)	דומינגז (אנטרה ריוס, ארגנטינה)	1
Dominica	דומיניקה	1
Dorchester (Dorset, England)	דורצ'סטר (דורסט, אנגליה)	1
Dornach (Switzerland)	דורנאך (שווייץ)	1
Dortmund (Germany)	דורטמונד (גרמניה)	1
Dover (England)	דובר (אנגליה)	1
Down (Northern Ireland)	דאון (צפון אירלנד)	1
Doylestown (Pa.)	דוילסטאון (פנסילבניה)	1
Dra Wadi (Morocco)	וואדי דראע (מרוקו)	1
Dresden (Germany)	דרזדן (גרמניה)	12
Drohobych (Ukraine)	דרוהוביץ (אוקראינה)	17
Druskininkai (Lithuania)	דרוסקינינקאי (ליטא)	1
Dubienka (Poland)	דוביינקה (פולין)	1
Dublin (Ireland)	דבלין (אירלנד)	5
Dubno (Ukraine)	דובנו (אוקראינה)	12
Dubova (Umansʹkyĭ raĭon, Ukraine)	דובובה (מחוז אומאנסק, אוקראינה)	1
Dukla (Poland)	דוקלה (פולין)	3
Dumfries (Scotland)	דומפריס (סקוטלנד)	1
Dunajská Streda (Slovakia)	דונסרדהלי (סלובקיה)	8
Durham (England)	דורהם (אנגליה)	2
Durham (N.C.)	דורהם (צפון קרולינה)	1
Düsseldorf (Germany)	דיסלדורף (גרמניה)	1
Dvorishte (Bulgaria)	דבורישטה (בולגריה)	1
Dyatlovo (Belarus)	ז'טל (בלארוס)	2
Dynów (Poland)	דינוב (פולין)	4
Dzeraunaia (Minskaia voblasts, Belarus)	דזרז'ינסק (בלארוס)	1
Działoszyce (Poland)	דזילושיץ (פולין)	3
Dzi︠a︡tlava (Belarus)	דזיאטלבה (בלארוס)	1
East Hampton (N.Y.)	איסט המפטון (ניו יורק)	1
East London (South Africa)	מזרח לונדון (דרום אפריקה)	1
Edelény (Hungary)	אדלין (הונגריה)	2
Edinburgh (Scotland)	אדינבורו (סקוטלנד)	7
Edirne (Turkey)	אדירנה (תורכיה)	6
Edmonton (Alta.)	אדמונטון (אלברטה)	1
Eger (Hungary)	אגר (הונגריה)	1
Egypt	מצרים	6
Eisenach (Germany)	אייזנאך (גרמניה)	1
Eisenstadt (Austria)	איזנשטט (אוסטריה)	5
Eišiškės (Lithuania)	אישישוק (ליטא)	1
Eisleben (Germany)	אייסלבן (גרמניה)	1
Ekaterinburg (Russia)	יקטרינבורג (רוסיה)	2
El Cajon (Calif.)	אל קאחון (קליפורניה)	1
Elizabeth (N.J.)	אליזבת (ניו ג'רזי)	2
Elon (Israel)	אילון (ישראל)	2
Emden (Germany)	אמדן (גרמניה)	2
En Dor (Israel)	עין דור (ישראל)	1
En Gev (Israel)	עין גב (ישראל)	6
En ha-Mifrats (Israel)	עין המפרץ (ישראל)	2
En Hahoresh (Israel)	עין החורש (ישראל)	8
En Harod (Israel)	עין חרוד (ישראל)	32
En Harod Me'uhad (Israel)	עין חרוד מאוחד (ישראל)	3
En Hashofet (Israel)	עין השופט (ישראל)	4
En Hod (Israel)	עין הוד (ישראל)	1
En Karmel (Israel)	עין כרמל (ישראל)	1
En Shemer (Israel)	עין שמר (ישראל)	4
En Vered (Israel)	עין ורד (ישראל)	1
Enat (Israel)	עינת (ישראל)	5
Encino (Los Angeles, Calif.)	אנסינו (לוס אנג'לס, קליפורניה)	1
England	אנגליה	10
Eretz Israel	ארץ ישראל	2
Erfurt (Germany)	ארפורט (גרמניה)	1
Erlangen (Germany)	ארלנגן (גרמניה)	1
Essaouira (Morocco)	מוגדור (מרוקו)	3
Essex (England)	אסקס (אנגליה)	1
Estonia	אסטוניה	2
Eugene (Or.)	יוג'ין (אורגון)	1
Even Yehuda (Israel)	אבן יהודה (ישראל)	1
Evergreen (Colo.)	אוורגרין (קולורדו)	1
Evpatoria (Ukraine)	יבפטוריה (אוקראינה)	2
Evron (Israel)	עברון (ישראל)	4
Exeter (England)	אקסטר (אנגליה)	1
Fair Lawn (N.J.)	פייר לאון (ניו ג'רזי)	1
Falaise (France)	פאלז (צרפת)	1
Falenica (Warsaw, Poland)	פלניץ (פולין)	2
Fălticeni (Romania)	פאלטיצ'ני (רומניה)	2
Faro (Portugal)	פארו (פורטוגל)	1
Fastiv (Ukraine)	פסטיב (אוקראינה)	2
Fehérgyarmat (Hungary)	פהרג'רמט (הונגריה)	1
Fermo (Italy)	פרמו (איטליה)	1
Ferrara (Italy)	פררה (איטליה)	7
Finland	פינלנד	1
Florence (Italy)	פירנצה (איטליה)	20
Florida	פלורידה	5
Fontenay-sous-Bois (France)	פונטניי סו בוה (צרפת)	1
Forbach (France)	פורבאק (צרפת)	1
Fordon (Poland)	פורדון (פולין)	2
Fort Pierce (Fla.)	פורט פירס (פלורידה)	1
France	צרפת	11
Frankfurt am Main (Germany)	פרנקפורט דמיין (גרמניה)	65
Frankfurt an der Oder (Germany)	פרנקפורט על האודר (גרמניה)	8
Fresno (Calif.)	פרזנו (קליפורניה)	1
Frysztak (Poland)	פריסטיק (פולין)	1
Fulda (Germany)	פולדה (גרמניה)	3
Fürth (Germany)	פירת (גרמניה)	16
Fusṭāṭ (Cairo, Egypt)	פוסטט (קהיר, מצרים)	5
Gadot (Israel)	גדות (ישראל)	2
Gailingen (Germany)	גילינגן (גרמניה)	1
Gal'ed (Israel)	גלעד (ישראל)	1
Galanta (Slovakia)	גלנטה (סלובקיה)	4
Galați (Romania)	גאלאץ (רומניה)	1
Galicia (Poland and Ukraine)	גליציה (פולין-אוקראינה)	22
Gallipoli (Turkey)	גליפולי (טורקיה)	1
Gan Shelomo (Israel)	גן שלמה (ישראל)	1
Gan Shemu'el (Israel)	גן שמואל (ישראל)	5
Gan Yavne (Israel)	גן יבנה (ישראל)	2
Gannot (Israel)	גנות (ישראל)	1
Gargždai (Lithuania)	גורזד (ליטא)	1
Gat (Israel)	גת (קיבוץ) (ישראל)	1
Gaza (Gaza Strip)	עזה (רצועת עזה)	3
Gdańsk (Poland)	גדנסק (פולין)	2
Gedera (Israel)	גדרה (ישראל)	5
Gela (Italy)	ג'לה (איטליה)	1
Gelil Yam (Israel)	גליל ים (ישראל)	1
Geneva (Switzerland)	ז'נבה (שווייץ)	12
Genoa (Italy)	ג'נואה (איטליה)	3
Gerona (Spain)	גרונה (ספרד)	1
Geva (Israel)	גבע (ישראל)	4
Gevar'am (Israel)	גברעם (ישראל)	1
Gevat (Israel)	גבת (ישראל)	4
Ghardaïa (Algeria)	גרדיה (אלג'יריה)	1
Gibraltar	גיברלטר	2
Ginnosar (Israel)	גינוסר (ישראל)	2
Giv'at Brener (Israel)	גבעת ברנר (ישראל)	8
Giv'at Hashelosha (Israel)	גבעת השלושה (ישראל)	8
Giv'at Hayyim (Israel)	גבעת חיים (מאוחד) (ישראל)	2
Giv'at Shemu'el (Israel)	גבעת שמואל (ישראל)	2
Giv'atayim (Israel)	גבעתיים (ישראל)	10
Glasgow (Scotland)	גלזגו (סקוטלנד)	4
Glendale (Calif.)	גלנדייל (קליפורניה)	1
Gloucester (Mass.)	גלוסטר (מסצ'וסטס)	1
Gloucestershire (England)	גלוסטרשייר (אנגליה)	1
Golan Heights (Israel)	רמת הגולן (ישראל)	1
Golčův Jeníkov (Czech Republic)	גולצוב יניקוב (צ'כיה)	1
Gorizia (Italy)	גוריציה (איטליה)	2
Gorlice (Poland)	גורליץ (פולין)	1
Göteborg (Sweden)	גוטברג (שבדיה)	1
Gotha (Germany)	גוטה (גרמניה)	1
Göttingen (Germany)	גוטינגן (גרמניה)	6
Gradisca d'Isonzo (Italy)	גרדיסקה ד'איזונצו (איטליה)	1
Grajewo (Poland)	גריוה (פולין)	3
Gran Canaria (Canary Islands)	גראן קנאריה (האיים הקנריים)	1
Grasse (France)	גראס (צרפת)	1
Graubünden (Switzerland)	גראובינדן (שווייץ)	1
Graz (Austria)	גרץ (אוסטריה)	2
Greece	יוון	2
Greenwich (Conn.)	גריניץ' (קונטיקט)	1
Grenada	גרנדה	1
Grenoble (France)	גרנובל (צרפת)	1
Grodzisk Wielkopolski (Poland)	גרידיץ (פולין)	1
Grybów (Poland)	גריבוב (פולין)	2
Guanabara Bay (Brazil)	מפרץ גואנאברה (ברזיל)	1
Guatemala	גואטמלה	1
Guelph (Ont.)	גואלף (אונטריו)	1
Guildford (England)	גילדפורד (אנגליה)	1
Gvozdets (Ukraine)	גבוז'דזיץ (אוקראינה)	1
Gyöngyös (Hungary)	ג'ונג'וש (הונגריה)	1
Hadera (Israel)	חדרה (ישראל)	7
Hague (Netherlands)	האג (הולנד)	13
Haifa (Israel)	חיפה (ישראל)	173
Hajduböszörmény (Hungary)	בסרמן (הונגריה)	1
Hajdudorog (Hungary)	דרג (הונגריה)	2
Hajdúhadház (Hungary)	האדהאז (הונגריה)	1
Hajdúnánás (Hungary)	הידוננש (הונגריה)	3
Hakirya (Tel Aviv-Yafo, Israel)	הקריה (תל אביב-יפו, ישראל)	1
Halberstadt (Germany)	הלברשטט (גרמניה)	5
Halle an der Saale (Germany)	האלה על נהר זאלה (גרמניה)	2
Halmeu (Romania)	הלמין (רומניה)	1
Hamadān (Iran)	המדאן (איראן)	1
Hamadya (Israel)	חמדיה (ישראל)	4
Hamburg (Germany)	המבורג (גרמניה)	27
Hamburg	המבורג	19
Hampstead (London, England)	המפסטד (לונדון, אנגליה)	1
Hanau (Germany)	הנאו (גרמניה)	1
Hanita (Israel)	חניתה (ישראל)	1
Hannover (Germany)	הנובר (גרמניה)	10
Hanover (N.H.)	האנובר (ניו המפשייר)	1
Haradzei︠a︡ (Belarus)	הרדזיה (בלארוס)	1
Harbin (China)	חרבין (סין)	1
Harlem (New York, N.Y.)	הרלם (ניו יורק, נ.י.)	1
Hartford (Conn.)	הרטפורד (קונטיקט)	2
Haute-Savoie (France)	סבואה עילית (צרפת)	1
Havana (Cuba)	הוואנה (קובה)	1
Hawaii	הוואי	1
Ḥawmat al-Sūq (Tunisia)	ג'רבה (תוניסיה)	43
Haworth (England)	הוורת (אנגליה)	1
Hazore'a (Israel)	הזורע (ישראל)	2
Hebron (West Bank)	חברון (גדה מערבית)	19
Heidelberg (Germany)	היידלברג (גרמניה)	3
Helets (Israel)	חלץ (ישראל)	1
Helsinki (Finland)	הלסינקי (פינלנד)	5
Hendaye (France)	אנדה (צרפת)	1
Herrlingen (Blaustein, Germany)	הרלינגן (בלאושטיין, גרמניה)	1
Hertfordshire (England)	הרטפורדשייר (אנגליה)	1
Herzeliyya (Israel)	הרצליה (ישראל)	18
Hilversum (Netherlands)	הילברסום (הולנד)	3
Hlukhiv (Ukraine)	חלוחיב (אוקראינה)	1
Hlusk (Belarus)	גלוסק (בלארוס)	1
Hlybokaye (Belarus)	גלובוקי (בלארוס)	2
Hlyni︠a︡ny (Ukraine)	גליניאני (אוקראינה)	4
Hod Hasharon (Israel)	הוד השרון (ישראל)	4
Hofit (Israel)	חופית (ישראל)	1
Hogla (Israel)	חוגלה (ישראל)	1
Hőgyész (Hungary)	הוג'ס (הונגריה)	3
Holešov (Czech Republic)	הולשאו (צ'כיה)	1
Hollywood (Los Angeles, Calif.)	הוליווד (לוס אנג'לס, קליפורניה)	8
Holon (Israel)	חולון (ישראל)	24
Hong Kong (China)	הונג קונג (סין)	2
Honolulu (Hawaii)	הונולולו (הוואי)	1
Horodenka (Ukraine)	הורודנקה (אוקראינה)	3
Hoshcha (Ukraine)	הושץ' (אוקראינה)	1
Houston (Tex.)	יוסטון (טקסס)	1
Houston Metropolitan Area (Tex.)	אזור מטרופולי יוסטון (טקסס)	1
Hrodna (Belarus)	גרודנו (בלארוס)	26
Hudson (N.Y.)	הדסון (ניו יורק)	1
Huedin (Romania)	הואדין (רומניה)	2
Hulata (Israel)	חולתה (ישראל)	2
Hulda (Israel)	חולדה (ישראל)	1
Ḥulwān (Egypt)	חלואן (מצרים)	1
Humenné (Slovakia)	הומנה (סלובקיה)	3
Huncovce (Slovakia)	אונסדורף (סלובקיה)	3
Hungary	הונגריה	2
Husi︠a︡tyn (Ukraine)	הוסיטין (אוקראינה)	1
Hyères (France)	היירס (צרפת)	1
Hythe (Kent, England)	היית' (קנט, אנגליה)	1
I︠A︡bluniv (Halyt︠s︡ʹkyĭ raĭon, Ukraine)	יבלונוב (אוקראינה)	1
I︠A︡lta (Ukraine)	ילטה (אוקראינה)	1
Iași (Romania)	יאסי (רומניה)	13
Idaho	איידהו	1
Illinois	אילינוי	1
Illintsi (Ukraine)	אילינצי (אוקראינה)	1
Ilok (Croatia)	אילוק (קרואטיה)	1
India	הודו	2
Indiana	אינדיאנה	2
Indura (Belarus)	אמדור (בלארוס)	1
Inglewood (Calif.)	אינגלווד (קליפורניה)	1
Innsbruck (Austria)	אינסברוק (אוסטריה)	1
Inowrocław (Poland)	אינוברוצלאב (פולין)	4
Iōannina (Greece)	ינינה (יוון)	1
Iowa	איווה	2
Ipswich (England)	איפסוויץ' (אנגליה)	1
Iraq	עיראק	1
Ireland	אירלנד	1
Irkutsk (Russia)	אירקוטסק (רוסיה)	1
Israel	ישראל	112
Israel	ישראל	1
Issy-les-Moulineaux (France)	איסי לה מולינו (צרפת)	1
Istanbul (Turkey)	איסטנבול (תורכיה)	57
Italy	איטליה	17
IV. Kerület (Budapest, Hungary)	בודפשט (הונגריה : מחוז 4)	1
Ivano-Frankivsʹk (Ukraine)	איוונו-פרנקיבסק (אוקראינה)	14
Izmaïl (Ukraine)	איזמאיל (אוקראינה)	1
İzmir (Turkey)	אזמיר (תורכיה)	81
Jaffa (Tel Aviv-Yafo, Israel)	יפו (תל אביב-יפו, ישראל)	23
Jamaica	ג'מיקה	1
Janów Lubelski (Poland)	יאנוב (פולין)	1
Japan	יפן	1
Jarbah Island (Tunisia)	ג'רבה (תוניסיה : אי)	1
Jarosław (Poland)	ירוסלב (פולין)	9
Jasionówka (Poland)	יאשינובקה (פולין)	1
Jasło (Poland)	יסלו (פולין)	1
Jedwabne (Poland)	ידובנה (פולין)	1
Jelgava (Latvia)	ילגבה (לטביה)	2
Jena (Germany)	יינה (גרמניה)	2
Jersey City (N.J.)	ג'רזי סיטי (ניו ג'רזי)	4
Jersey	גרזי (אי)	1
Jerusalem (Israel)	ירושלים (ישראל)	1566
Jerusalem (Israel)	ירושלים (ישראל)	
Jihlava (Czech Republic)	ילאבה (צ'כיה)	1
Johannesburg (South Africa)	יוהנסבורג (דרום אפריקה)	15
Johannisburg (Germany)	יוהניסבורג (גרמניה)	1
Jonava (Lithuania)	ינובה (ליטא)	1
Józefów (Poland)	יוזפוף (פולין)	1
Jutland (Denmark)	יוטלנד (דנמרק)	1
Kakhovka (Ukraine)	קחובקה (אוקראינה)	1
Kaliningrad (Kaliningradskaia oblast, Russia)	קלינינגרד (מחוז קלינינגרד, רוסיה)	10
Kalisz (Poland)	קליש (פולין)	4
Kalush (Ukraine)	קלוש (אוקראינה)	3
Kałuszyn (Warsaw, Poland)	קאלושין (ורשה, פולין)	1
Kalvarija (Lithuania)	קלווריה (ליטא)	3
Kam'i︠a︡net︠s︡ʹ-Podilʹsʹkyĭ (Ukraine)	קמיניץ-פודולסק (אוקראינה)	2
Kaposvár (Hungary)	קפוסבר (הונגריה)	1
Kapyl (Belarus)	קפוליה (בלארוס)	1
Karcag (Szolnok Megye, Hungary)	קרצג (מחוז סולנוק, הונגריה)	1
Karkur (Israel)	כרכור (ישראל)	2
Karlin (Belarus)	קרלין (בלארוס)	5
Karlovy Vary (Czech Republic)	קרלובי ורי (צ'כיה)	4
Katowice (Poland)	קטוביץ (פולין)	1
Kaunas (Lithuania)	קובנה (ליטא)	31
Kėdainiai (Lithuania)	קדאייני (ליטא)	3
Kefar Avraham (Israel)	כפר אברהם (ישראל)	2
Kefar Azar (Israel)	"כפר אז""ר (ישראל)"	1
Kefar Darom (Gaza Strip)	כפר דרום (רצועת עזה)	2
Kefar Gil'adi (Israel)	כפר גלעדי (ישראל)	3
Kefar Hamakkabi (Israel)	כפר המכבי (ישראל)	1
Kefar Haro'e (Israel)	"כפר הרא""ה (ישראל)"	1
Kefar Hasidim (Israel)	כפר חסידים (ישראל)	1
Kefar Mallal (Israel)	"כפר מל""ל (ישראל)"	1
Kefar Pines (Israel)	כפר פינס (ישראל)	2
Kefar Sava (Israel)	כפר סבא (ישראל)	10
Kefar Shemaryahu (Israel)	כפר שמריהו (ישראל)	5
Kefar Vitkin (Israel)	כפר ויתקין (ישראל)	1
Kefar Yehezkel (Israel)	כפר יחזקאל (ישראל)	1
Kefar Yehoshu'a (Israel)	כפר יהושוע (ישראל)	4
Kelme (Lithuania)	קלם (ליטא)	3
Kelmscot (England)	קלמסקוט (אנגליה)	1
Kensington (London, England)	קנסינגטון (לונדון, אנגליה)	1
Kensington and Chelsea (London, England)	קנסינגטון וצ'לסי (לונדון, אנגליה)	1
Kent (England)	קנט (אנגליה)	1
Kerkyra (Greece)	קורפו (יוון : עיר)	3
Kermanshah (Iran)	כרמאנשאה (איראן)	2
Kern County (Calif.)	מחוז קרן (קליפורניה)	1
Keswick (Cumbria, England)	קזוויק (קאמבריה, אנגליה)	1
Keszthely (Hungary)	קסתלי (הונגריה)	1
Key West (Fla.)	קי ווסט (פלורידה)	2
Kežmarok (Slovakia)	קז'מרוק (סלובקיה)	1
Khabarovsk (Russia)	חברובסק (רוסיה)	1
Kharkiv (Ukraine)	חרקוב (אוקראינה)	8
Kherson (Ukraine)	חרסון (אוקראינה)	4
Khislavichi (Russia)	חסלאוויטש (רוסיה)	1
Khmelnytskyi (Ukraine)	חמלניצקי (אוקראינה)	1
Khorostkiv (Ukraine)	חראשקוב (אוקראינה)	3
Khust (Ukraine)	חוסט (אוקראינה)	7
Khyriv (Ukraine)	חירוב (אוקראינה)	1
Kielce (Poland)	(קילץ (פולין	4
Kiev (Ukraine)	קייב (אוקראינה)	41
Kingston (N.Y.)	קינגסטון (ניו יורק)	2
Kingston upon Thames (London, England)	קינגסטון שעל התמזה (לונדון, אנגליה)	1
Kinneret (Moshava) (Israel)	כנרת (מושבה : ישראל)	2
Kirchheim unter Teck (Germany)	קירכהיים אונטר טק (גרמניה)	1
Kirovohrad (Ukraine)	קירובגרד (אוקראינה)	1
Kiryas Joel (N.Y.)	קרית יואל (ניו יורק)	1
Kiryat Anavim (Israel)	קרית ענבים (ישראל)	5
Kiryat Arba (West Bank)	קרית ארבע (גדה מערבית)	1
Kiryat Ata (Israel)	קרית אתא (ישראל)	1
Kiryat Hayyim (Haifa, Israel)	קרית חיים (חיפה, ישראל)	1
Kiryat Mal'akhi (Israel)	קרית מלאכי (ישראל)	1
Kiryat Motzkin (Israel)	קרית מוצקין (ישראל)	4
Kiryat Ono (Israel)	קרית אונו (ישראל)	2
Kiryat Shaul (Ramat Hasharon, Israel)	קרית שאול (רמת השרון, ישראל)	1
Kiryat Shemona (Israel)	קרית שמונה (ישראל)	1
Kiryat Shemuel (Israel)	קריית שמואל (ישראל)	1
Kiryat Tivon (Israel)	קרית טבעון (ישראל)	3
Kiryat Yam (Israel)	קרית ים (ישראל)	1
Kiryat Ye'arim (Israel)	קרית יערים (ישראל)	1
Kiskőrös (Hungary)	קישקורוש (הונגריה)	2
Kislovodsk (Russia)	קיסלובודסק (רוסיה)	1
Kisvárda (Hungary)	קישורדא (הונגריה)	9
Kitzingen (Germany)	קיצינגן (גרמניה)	1
Kletsk (Belarus)	קלצק (בלארוס)	3
Klosterneuburg (Austria)	קלוסטרנויבורג (אוסטריה)	1
Kobryn (Belarus)	קוברין (בלארוס)	9
Kock (Poland)	קוצק (פולין)	1
Kodeń (Poland)	קודן (פולין)	1
Kojetín (Czech Republic)	קויטין (צ'כיה)	2
Kolbuszowa (Poland)	קולבושובה (פולין)	2
Kolín (Czech Republic)	קולין (צ'כיה)	2
Kolno (Łomża, Poland)	קולנה (לומז'ה, פולין)	2
Koło (Konin, Poland)	קולו (קונין, פולין)	1
Kolomyi︠a︡ (Ukraine)	קולומיה (אוקראינה)	7
Komarno (Ukraine)	קומרנה (אוקראינה)	3
Komárom (Hungary)	קומרום (הונגריה)	2
Końskowola (Poland)	קונסקה וולה (פולין)	1
Kopys (Belarus)	קופוסט (בלארוס)	2
Korazim (Israel)	כורזים (ישראל)	1
Koret︠s︡ʹ (Ukraine)	קוריץ (אוקראינה)	1
Kórnik (Poland)	קורניק (פולין)	1
Kos (Greece)	קוס (יוון)	1
Košice (Slovakia)	קושיצה (סלובקיה)	4
Kosiv (Ukraine)	קוסוב (אוקראינה)	5
Kosyny (Ukraine)	קוסיני (אוקראינה)	3
Koszyce (Województwo Małopolskie, Poland)	קושיץ (פולין קטן)	1
Kozienice (Poland)	קוז'ניץ (פולין)	3
Krakow (Poland)	קרקוב (פולין)	100
Krasnobród (Poland)	קרסנוברוד (פולין)	1
Krasnodarskii krai (Russia)	קרסנודאר (רוסיה)	1
Kražiai (Lithuania)	קרז (ליטא)	1
Krefeld (Germany)	קרפלד (גרמניה)	1
Krekenava (Lithuania)	קרקינובה (ליטא)	1
Kremenchuk (Ukraine)	קרמנצ'וג (אוקראינה)	1
Kremenets (Ukraine)	קרמניץ (אוקראינה)	7
Kremnica (Slovakia)	קרמניצה (סלובקיה)	1
Krotoszyn (Kalisz, Poland)	קרוטושין (קליש, פולין)	5
Krynki (Poland)	קרינקי (פולין)	1
Kryve Ozero (Ukraine)	קריבויה אוזרו (אוקראינה)	1
Krzeszów (Jelenia Góra, Poland)	קז'אשוב (פולין)	2
Krzywcza (Poland)	קריפטש (פולין)	2
Kupiškis (Lithuania)	קופישוק (ליטא)	1
Kursk (Russia)	קורסק (רוסיה)	1
Kutno (Poland)	קוטנו (פולין)	3
Kuty (Ukraine)	קוטוב (אוקראינה)	5
Lʹviv (Ukraine)	לבוב (אוקראינה)	110
La Jolla (San Diego, Calif.)	לה הויה (סן דייגו, קליפורניה)	3
Lackenbach (Austria)	לקנבך (אוסטריה)	1
Lafayette (Ind.)	לאפייט (אינדיאנה)	1
Lahavot Habashan (Israel)	להבות הבשן (ישראל)	1
Lahore (Pakistan)	להור (פקיסטן)	1
Lake District (England)	מחוז האגמים (אנגליה)	1
Lake Elsinore (Calif.)	אגם אלסינור (קליפורניה)	1
Lakewood (N.J.)	לייקווד (ניו ג'רזי)	5
Lambaréné (Moyen-Ogooué, Gabon)	למברנה (גבון)	1
Lancaster (Calif.)	לנקסטר (קליפורניה)	1
Łańcut (Poland)	לנצוט (פולין)	2
Lanzarote (Canary Islands)	לנזרוטה (האיים הקנריים)	1
Laren (North Holland, Netherlands)	לארן (צפון הולנד, הולנד)	1
Larisa (Greece)	לריסה (יוון)	1
Lask (Poland)	לאסק (פולין)	6
Lausanne (Switzerland)	לוזאן (שווייץ)	5
Leatherhead (England)	לת'רהד (אנגליה)	1
Lebanon	לבנון	1
Łęczyca (Poland)	לונטשיץ (פולין)	2
Leeds (England)	לידס (אנגליה)	3
Leeuwarden (Netherlands)	ליאווארדן (הולנד)	1
Leicester (England)	לסטר (אנגליה)	1
Leiden (Netherlands)	ליידן (הולנד)	1
Leipzig (Germany)	ליפציג (גרמניה)	17
Lemgo (Germany)	למגו (גרמניה)	1
Leningrad (R.S.F.S.R.)	לנינגראד (רוסיה)	6
Lesko (Poland)	לסקו (פולין)	1
Leszno (Poland)	לשנו (פולין)	10
Letchworth (England)	לצ'וורת' (אנגליה)	1
Levelek (Hungary)	לעוועלעק (הונגריה)	1
Lexington (Mass.)	לקסינגטון (מסצ'וסטס)	1
Leżajsk (Poland)	ליז'נסק (פולין)	6
Liberty (N.Y.)	ליברטי (ניו יורק)	1
Libná (Czech Republic)	ליבנא (צ'כיה)	1
Lida (Belarus)	לידה (בלארוס)	3
Lido (Italy)	לידו (איטליה)	1
Liège (Belgium)	ליאז' (בלגיה)	1
Liepāja (Latvia)	ליפאיה (לטביה)	4
Lier (Belgium)	לייר (בלגיה)	1
Liestal (Switzerland)	ליסטל (שווייץ)	1
Lillehammer (Norway)	לילהאמר (נורבגיה)	1
Lima (Peru)	לימה (פרו)	1
Limanowa (Poland)	לימינוב (פולין)	1
Limpsfield (England)	לימפספילד (אנגליה)	1
Lincoln (Neb.)	לינקולן (נברסקה)	1
Lindheim (Altenstadt, Hesse, Germany)	לינדהיים (אלטנשטדט, הסן, גרמניה)	1
Linz (Austria)	לינץ (אוסטריה)	1
Lipník nad Bečvou (Czech Republic)	ליפניק (צ'כיה)	6
Lipno (Włocławek, Poland)	ליפנו (ולוצלאווק, פולין)	1
Lisbon (Portugal)	ליסבון (פורטוגל)	13
Lithuania	ליטא	1
Li︠u︡bavichi (Russia)	ליובויץ' (רוסיה)	2
Liverpool (England)	ליורפול (אנגליה)	2
Livorno (Italy)	ליוורנו (איטליה)	25
Locarno (Switzerland)	לוקרנו (שווייץ)	4
Lod (Israel)	לוד (ישראל)	2
Łódź (Poland)	לודז' (פולין)	43
Lohame Hageta'ot (Israel)	לוחמי הגטאות (ישראל)	1
Lokachi (Ukraine)	לוקץ' (אוקראינה)	1
Lokhvyt︠s︡i︠a︡ (Ukraine)	לוחביצה (אוקראינה)	1
Lomas de Zamora (Argentina)	לומאס דה זאמורה (ארגנטינה)	1
Łomazy (Poland)	לומז (פולין)	2
Łomża (Poland)	לומזה (פולין)	3
London (England)	לונדון (אנגליה)	271
London (Ont.)	לונדון (אונטריו)	1
Long Beach (Calif.)	לונג ביץ' (קליפורניה)	1
Long Beach (N.Y.)	לונג ביץ' (ניו יורק)	1
Long Branch (N.J.)	לונג ברנץ' (ניו ג'רזי)	1
Long Island (N.Y.)	לונג איילנד (ניו יורק)	1
Los Angeles (Calif.)	לוס אנג'לס (קליפורניה)	97
Louisiana	לואיזיאנה	1
Lourmarin (France)	לורמרין (צרפת)	1
Louveciennes (France)	לובסיאן (צרפת)	1
Łowicz (Poland)	לוביץ' (פולין)	1
Lubaczów (Poland)	לובאצ'וב (פולין)	1
Lübeck (Germany)	ליבק (גרמניה)	2
Lublin (Poland)	לובלין (פולין)	32
Lucca (Italy)	לוקה (איטליה)	2
Lučenec (Slovakia)	לושונץ (סלובקיה)	1
Lucerne (Switzerland)	לוצרן (שווייץ)	2
Ludza (Latvia)	לודזה (לטביה)	2
Lugano (Switzerland)	לוגאנו (שווייץ)	2
Lugo (Italy)	לוגו (איטליה)	2
Luhansʹk (Luhansʹka oblastʹ, Ukraine)	לוגנסק (אוקראינה)	1
Łuków (Siedlce, Poland)	לוקוב (פולין)	1
Lunel (France)	לוניל (צרפת)	1
Lunéville (France)	לינוויל (צרפת)	1
Lutomiersk (Poland)	לוטומיירסק (פולין)	1
Lutowiska (Poland)	לוטוביסקה (פולין)	1
Luxembourg	לוכסמבורג	1
Luzzara (Italy)	לוזרה (איטליה)	1
Lyady (Belarus)	ליאדי (בלארוס)	2
Lyakhavichy (Belarus)	לחוביץ' (בלארוס)	1
Lyck (Germany)	ליק (גרמניה)	2
Lyon (France)	ליון (צרפת)	1
Ma'agan (Israel)	מעגן (ישראל)	1
Ma'ale Hahamisha (Israel)	מעלה החמישה (ישראל)	1
Ma'anit (Israel)	מענית (ישראל)	2
Ma'barot (Israel)	מעברות (ישראל)	3
Ma'oz Hayyim (Israel)	מעוז חיים (ישראל)	1
Mád (Hungary)	מאד (הונגריה)	3
Madanīn (Tunisia)	מדנין (תוניסיה)	1
Madison (Wis.)	מדיסון (ויסקונסין)	3
Madrid (Spain)	מדריד (ספרד)	13
Magdiel (Hod Hasharon, Israel)	מגדיאל (הוד השרון, ישראל)	5
Mahanayim (Israel)	מחניים (ישראל)	1
Mahili︠o︡ŭ (Belarus)	מוהילב (בלארוס)	4
Maine	מיין	1
Mainz (Rhineland-Palatinate, Germany)	מינץ (רינלנד-פלטינט, גרמניה)	1
Makó (Hungary)	מקובה (הונגריה)	5
Malakoff (France)	מלקוף (צרפת)	1
Manchester (England)	מנצ'סטר (אנגליה)	13
Manhattan (New York, N.Y.)	מנהטן (ניו יורק, נ.י.)	16
Mannheim (Germany)	מנהיים (גרמניה)	2
Mantua (Italy)	מנטובה (איטליה)	33
Marblehead (Mass.)	מרבלהד (מסצ'וסטס)	1
Marburg (Germany)	מרבורג (גרמניה)	2
Marghita (Romania)	מרגרטן (רומניה)	2
Marseille (France)	מרסי (צרפת)	6
Marvejols (France)	מארבז'ול (צרפת)	1
Maryland	מרילנד	1
Mashhad (Iran)	משהד (איראן)	1
Massachusetts	מסצ'וסטס	5
Mátészalka (Hungary)	מטסלקה (הונגריה)	1
Mattersburg (Austria)	מטרסדורף (אוסטריה)	6
McKeesport (Pa.)	מקקיספורט (פנסילבניה)	1
Medina (Saudi Arabia)	מדינה (ערב הסעודית)	1
Medz︠h︡ybiz︠h︡ (Ukraine)	מז'יבוז' (אוקראינה)	4
Melbourne (Vic.)	מלבורן (ויקטוריה)	12
Memphis (Tenn.)	ממפיס (טנסי)	1
Menara (Israel)	מנרה (ישראל)	1
Menton (France)	מנטון (צרפת)	2
Merano (Italy)	מראנו (איטליה)	4
Merhavya (Israel)	מרחביה (ישראל)	5
Merkinė (Lithuania)	מרטש (ליטא)	1
Merseburg (Germany)	מרזהבורג (גרמניה)	1
Metula (Israel)	מטולה (ישראל)	1
Metz (France)	מץ (צרפת)	10
Meudon (France)	מודון (צרפת)	1
Mexico City (Mexico)	מקסיקו סיטי (מקסיקו)	19
Mexico	מקסיקו	7
Mezőszilas (Hungary)	סילאש (הונגריה)	2
Miami (Fla.)	מיאמי (פלורידה)	7
Michelstadt (Germany)	מיכלשטט (גרמניה)	1
Michigan	מישיגן	1
Middlesex (England)	מידלסקס (אנגליה)	1
Międzyrzec Podlaski (Poland)	מזריץ' (פולין)	2
Mielec (Poland)	מליץ (פולין)	3
Migdal (Israel)	מגדל (ישראל)	1
Mihăileni (Botoşani, Romania)	מיכאילן (בוטושן, רומניה)	1
Mikhmoret (Israel)	מכמורת (ישראל)	1
Mikulov (Jihomoravský kraj, Czech Republic)	מיקולוב (מורביה הדרומית, צ'כיה)	14
Mikve Yisra'el (Israel)	מקווה ישראל (ישראל)	1
Milan (Italy)	מילנו (איטליה)	11
Miltenberg (Germany)	מילטנברג (גרמניה)	1
Milwaukee (Wis.)	מילווקי (ויסקונסין)	2
Minneapolis (Minn.)	מיניאפוליס (מינסוטה)	3
Minnesota	מינסוטה	1
Minsk (Belarus)	מינסק (בלארוס)	49
Mińsk Mazowiecki (Poland)	מינסק מזובייצקי (פולין)	2
Minusio (Switzerland)	מניוסיו (שווייץ)	1
Mir (Belarus)	מיר (בלארוס)	4
Miseno (Italy)	מיסנו (איטליה)	1
Mishmar Ha'emek (Israel)	משמר העמק (ישראל)	5
Mishmar Hanegev (Israel)	משמר הנגב (ישראל)	2
Mishmar Hasharon (Israel)	משמר השרון (ישראל)	3
Mishmar Hayarden (Israel)	משמר הירדן (ישראל)	1
Mishmarot (Israel)	משמרות (ישראל)	1
Miskolc (Hungary)	מישקולץ (הונגריה)	5
Missouri	מיזורי	2
Mizra (Israel)	מזרע (ישראל)	7
Mladá Boleslav (Czech Republic)	מלאדה בולסלב (צ'כיה)	3
Mlyniv (Ukraine)	מלינוב (אוקראינה)	1
Modena (Italy)	מודנה (איטליה)	10
Mohyliv-Podilʹsʹkyĭ (Ukraine)	מויליב-פודילסקי (אוקראינה)	1
Moisés Ville (Argentina)	מוזסטויל (ארגנטינה)	1
Moledet (Israel)	מולדת (מושב)	3
Monasterzyska (Poland)	מונאסטרישץ' (פולין)	1
Moncalieri (Italy)	מונקאליירי (איטליה)	1
Monroeville (Ala.)	מונרוויל (אלבמה)	1
Monsey (N.Y.)	מונסי (ניו יורק)	3
Montagnana (Italy)	מונטאניאנה (איטליה)	1
Monte-Carlo (Monaco)	מונטה קרלו (מונקו)	2
Montevideo (Uruguay)	מונטווידאו (אורוגוואי)	8
Montmorency (France)	מונמורנסי (צרפת)	1
Montpellier (France)	מונפלייה (צרפת)	2
Montréal (Québec)	מונטריאול (קוויבק)	38
Montreux (Switzerland)	מונטרה (שווייץ)	2
Mór (Hungary)	מור (הונגריה)	2
Morocco	מרוקו	1
Mosbach (Baden-Württemberg, Germany)	מוסבאך (גרמניה)	1
Moscow (Russia)	מוסקבה (רוסיה)	153
Mosul (Iraq)	מוצל (עיראק)	2
Mougins (France)	מוג'ן (צרפת)	1
Mount Kisco (N.Y.)	מאונט קיסקו (ניו יורק)	2
Mstsislaŭ (Belarus)	מסטיסלאו (בלארוס)	2
Mstsislaw (Belarus)	אמסטיסלב (בלארוס)	1
Mukacheve (Ukraine)	מונקטש (אוקראינה)	20
Muknīn (Tunisia)	מוכנין (תוניסיה)	1
Mumbai (India)	מומבאי (הודו)	1
Munich (Germany)	מינכן (גרמניה)	24
Murfreesboro (Tenn.)	מורפריסבורו (טנסי)	1
Mykolaïv (Mykolaïvsʹka oblastʹ, Ukraine)	מיקולייב (מחוז מיקולייב, אוקראינה)	3
Mykulynt︠s︡i (Ukraine)	מיקולינצי (אוקראינה)	1
Na'an (Israel)	נען (ישראל)	9
Nabeul (Tunisia)	נבל (תוניסיה)	1
Nablus (West Bank)	שכם (גדה מערבית)	3
Náchod (Královéhradecký kraj, Czech Republic)	נאחוד (מחוז הראדץ קראלובה, צ'כיה)	2
Nadvirna (Ukraine)	נדבורנה (אוקראינה)	7
Nagykálló (Hungary)	קלוב (הונגריה)	2
Nagykanizsa (Hungary)	נג'קניז'ה (הונגריה)	1
Nahal Oz (Israel)	נחל עוז (ישראל)	1
Nahalal (Israel)	נהלל (ישראל)	8
Nahalat Yits'hak (Tel Aviv-Yafo, Israel)	נחלת יצחק (תל אביב-יפו, ישראל)	4
Nahariyya (Israel)	נהריה (ישראל)	6
Nancy (France)	ננסי (צרפת)	1
Naples (Italy)	נאפולי (איטליה)	11
Narbonne (France)	נרבון (צרפת)	2
Narva (Estonia)	נרבה (אסטוניה)	1
Nasielsk (Poland)	נאשלסק (פולין)	2
Navahrudak (Belarus)	נובהרדוק (בלארוס)	2
Nazareth (Israel)	נצרת (ישראל)	2
Ne'ot Mordekhai (Israel)	נאות מרדכי (ישראל)	2
Negba (Israel)	נגבה (ישראל)	1
Negev (Israel)	נגב (ישראל)	1
Nehalim (Israel)	נחלים (ישראל)	1
Nemakščiai (Lithuania)	נמקשט (ליטא)	2
Nemyriv (Lʹvivsʹka oblastʹ, Ukraine)	נמירוב (אוקראינה)	2
Nes Tsiyyona (Israel)	נס ציונה (ישראל)	5
Nesterov (Kaliningradskai︠a︡ oblastʹ, Russia)	נסטרוב (מחוז קלינינגרד, רוסיה)	3
Netanya (Israel)	נתניה (ישראל)	11
Netherlands	הולנד	2
Netivot (Israel)	נתיבות (ישראל)	3
Netser Sereni (Israel)	נצר סרני (ישראל)	1
Neuilly-sur-Seine (France)	נויי-סור-סן (צרפת)	1
Neve Etan (Israel)	נווה איתן (ישראל)	1
New Britain (Conn.)	ניו בריטן (קונטיקט)	1
New Canaan (Conn.)	ניו כנען (קונטיקט)	1
New Delhi (India)	ניו דלהי (הודו)	1
New Hampshire	ניו המפשיר	1
New Haven (Conn.)	ניו הייבן (קונטיקט)	6
New Jersey	ניו ג'רזי	5
New Orleans (La.)	ניו אורלינס (לואיזיאנה)	4
New Rochelle (N.Y.)	ניו רושל (ניו יורק)	4
New South Wales	ניו סאות' ויילס	1
New York (N.Y.)	ניו יורק (נ.י.)	918
New York (State)	ניו יורק (מדינה)	1
New Zealand	ניו-זילנד	1
Newark (N.J.)	ניוארק (ניו ג'רזי)	6
Newcastle upon Tyne (England)	ניוקאסל על נהר טיין (אנגליה)	2
Newton (Mass.)	ניוטון (מסצ'וסטס)	2
Ni︠a︡sviz︠h︡ (Belarus)	נסויז' (בלארוס)	1
Nice (France)	ניס (צרפת)	13
Nir David (Israel)	ניר דוד (ישראל)	1
Nir Gallim (Israel)	ניר גלים (ישראל)	1
Nirim (Israel)	נירים (ישראל)	2
Nitra (Slovakia)	ניטרה (סלובקיה)	1
Niz︠h︡yn (Ukraine)	ניזהין (אוקראינה)	1
Nohant-Vic (France)	נואן-ויק (צרפת)	1
Noisy-le-Sec (France)	נואזי-לה-סק (צרפת)	1
Norfolk Island	נורפולק (אי)	1
Norman (Okla.)	נורמן (אוקלהומה)	1
North Bergen (N.J.)	נורת' ברגן (ניו ג'רזי)	1
North Carolina	קרולינה הצפונית	1
Norway	נורבגיה	1
Norwich (England)	נוריץ' (אנגליה)	1
Nottingham (England)	נוטינגהאם (אנגליה)	1
Nové Mesto nad Váhom (Slovakia)	עיר חדש (סלובקיה)	4
Nove Zamky (Slovakia)	ניהיזל (סלובקיה)	1
Novohrad-Volynsʹkyĭ (Ukraine)	נובוהרד-ולינסקי (אוקראינה)	3
Nowy Sącz (Poland)	צנז (פולין)	6
Nușeni (Romania)	נושני (רומניה)	3
Nyírbátor (Hungary)	ניירבטור (הונגריה)	4
Nyíregyháza (Hungary)	נירג'הזה (הונגריה)	3
Nyírlugos (Hungary)	לוגאש (הונגריה)	1
Oakland (Calif.)	אוקלנד (קליפורניה)	1
Óbuda (Hungary)	אובודה (הונגריה)	2
Odesa (Ukraine)	אודסה (אוקראינה)	42
Ofakim (Israel)	אופקים (ישראל)	2
Offenbach am Main (Germany)	אופנבך אם מיין (גרמניה)	4
Ogden (Utah)	אוגדן (יוטה)	1
Ohio	אוהיו	2
Olkusz (Poland)	אולקוש (פולין)	1
Olyka (Ukraine)	אוליקה (אוקראינה)	1
Omaha (Neb.)	אומהה (נברסקה)	1
Opatów (Tarnobrzeg, Poland)	אפטה (פולין)	2
Oradea (Romania)	אורדיאה מרה (רומניה)	16
Oran (Algeria)	אורן (אלג'יריה)	4
Orissa (India)	אוריסה (הודו)	1
Orla (Poland)	אורלה (פולין)	2
Orléans (France)	אורליאן (צרפת)	1
Orlovo (Altaĭskiĭ kraĭ, Russia)	אורלובן (מחוז אלטייה, רוסיה)	1
Ostend (Belgium)	אוסטנדה (בלגיה)	1
Ostroh (Ukraine)	אוסטרהא (אוקראינה)	13
Ostrołęka (Ostrołęka, Poland)	אוסטרולקה (אוסטרולקה, פולין)	2
Ostrów Mazowiecka (Poland)	אוסטרוב מזוביצק (פולין)	1
Ostrów Wielkopolski (Poland)	אוסטרוב ויילקופולסקי (פולין)	3
Ostrowiec Świętokrzyski (Poland)	אוסטרוביץ (פולין)	3
Ostryna (Belarus)	אוסטרין (בלארוס)	1
Oświęcim (Poland)	אושויץ (פולין)	50
Ottensen (Hamburg, Germany)	אוטנזה (המבורג, גרמניה)	1
Otwock (Poland)	אוטבוצק (פולין)	12
Oujda (Morocco)	אוג'דה (מרוקו)	2
Oxford (England)	אוקספורד (אנגליה)	13
Oxfordshire (England)	אוקספורדשייר (אנגליה)	1
Ozorków (Poland)	אזארקוו (פולין)	2
Pabianice (Poland)	פביניץ (פולין)	1
Padua (Italy)	פדובה (איטליה)	18
Paks (Hungary)	פקש (הונגריה)	4
Palanga (Lithuania)	פלנגה (ליטא)	2
Palermo (Italy)	פלרמו (איטליה)	2
Palm Beach (Fla.)	פאלם ביץ' (פלורידה)	1
Palm Springs (Calif.)	פאלם ספרינגס (קליפורניה)	5
Palmahim (Israel)	פלמחים (ישראל)	1
Paneriai (Lithuania)	פונר (ליטא)	5
Panevezys (Lithuania)	פוניבז' (ליטא)	3
Pardes Hanna-Karkur (Israel)	פרדס חנה - כרכור (ישראל)	2
Paris (France)	פריס (צרפת)	253
Paris (France)	פריס (צרפת)	1
Pasadena (Calif.)	פסדינה (קליפורניה)	1
Passaic (N.J.)	פסאיק (ניו ג'רזי)	1
Paterson (N.J.)	פטרסון (ניו ג'רזי)	1
Pavia (Italy)	פאביה (איטליה)	1
Pavlivka (Ukraine)	פבליבקה (אוקראינה)	2
Pécs (Hungary)	פץ' (הונגריה)	2
Peñafiel (Spain)	פניאפייל (ספרד)	1
Pennsylvania	פנסילבניה	1
Peoria (Ill.)	פאוריה (אילינוי)	1
Peredelkino (Russia)	פרדלקינו (רוסיה)	1
Peremyshli︠a︡ny (Ukraine)	פרמישלן (אוקראינה)	3
Perpignan (France)	פרפיניאן (צרפת)	2
Pesaro (Italy)	פזרו (איטליה)	1
Pest (Hungary)	פשט (הונגריה)	2
Petah Tikva (Israel)	פתח תקווה (ישראל)	68
Petaluma (Calif.)	פטלומה (קליפורניה)	2
Petrópolis (Brazil)	פטרופוליס (ברזיל)	1
Pezinok (Slovakia)	פזינוק (סלובקיה)	1
Pfersee (Augsburg, Germany)	פפרסה (אוגסבורג, גרמניה)	3
Philadelphia (Pa.)	פילדלפיה (פנסילבניה)	42
Phoenix (Ariz.)	פיניקס (אריזונה)	2
Pi︠a︡tigorsk (Russia)	פיאטיגורסק (רוסיה)	1
Pidvolochysʹk (Ukraine)	פאדוואלאטשוסקא (אוקראינה)	1
Piešt̕any (Slovakia)	פיאסטני (סלובקיה)	2
Pinczów (Poland)	פינצוב (פולין)	4
Pinsk (Belarus)	פינסק (בלארוס)	9
Piotrkow Trybunalski (Poland)	פיוטרקוב (פולין)	7
Pisa (Italy)	פיזה (איטליה)	2
Pittsburgh (Pa.)	פיטסברג (פנסילבניה)	10
Plano (Tex.)	פליינו (טקסס)	1
Pławno (Poland)	פלאוונו (פולין)	1
Płock (Poland)	פלוצק (פולין)	4
Płońsk (Poland)	פלונסק (פולין)	1
Plovdiv (Bulgaria)	פלובדיב (בולגריה)	1
Plungė (Lithuania)	פלונגין (ליטא)	1
Podgorze (Krakow, Poland)	פודגורזה (קרקוב, פולין)	2
Podillia (Ukraine)	פודיליה (אוקראינה)	1
Podu Iloaiei (Romania)	פודו אילואיי (רומניה)	1
Poitiers (France)	פואטייה (צרפת)	1
Poland	פולין	21
Polná (Jihomoravský kraj, Czech Republic)	פולנה (ז'יומוראבסקי קרא, צ'כיה)	1
Polonne (Ukraine)	פולונה (אוקראינה)	4
Poltava (Ukraine)	פולטבה (אוקראינה)	2
Poriyya Illit (Israel)	פורייה עילית (ישראל)	1
Portland (Me.)	פורטלנד (מיין)	1
Portland (Or.)	פורטלנד (אורגון)	1
Porto (Portugal)	פורטו (פורטוגל)	1
Portugal	פורטוגל	2
Potsdam (Germany)	פוטסדם (גרמניה)	2
Poughkeepsie (N.Y.)	פוקיפסי (ניו יורק)	1
Poznań (Poland)	פוזנן (פולין)	15
Prague (Czech Republic)	פראג (צ'כיה)	84
Princeton (N.J.)	פרינסטון (ניו ג'רזי)	10
Prostějov (Czech Republic)	פרוסטיוב (צ'כיה)	2
Provence (France)	פרובנס (צרפת)	2
Providence (R.I.)	פרובידנס (רוד איילנד)	3
Pruz︠h︡any (Belarus)	פרוז'ני (בלארוס)	3
Przedbórz (Piotrków Trybunalski, Poland)	פשדבוז (פיוטרקוב טריבונלסקי, פולין)	1
Przemyśl (Poland)	פשמישל (פולין)	24
Przysucha (Poland)	פשיסחא (פולין)	1
Púchov (Slovakia)	פוכוב (סלובקיה)	1
Puerto Rico	פוארטו ריקו	1
Puławy (Poland)	פולבי (פולין)	2
Püspökladány (Hungary)	פישפוקלדן (הונגריה)	1
Putney (London, England)	פאטני (לונדון, אנגליה)	1
Putnok (Hungary)	פוטנוק (הונגריה)	2
Pyskowice (Katowice, Poland)	פיסקוויץ (קטוביץ, פולין)	1
Qābis (Tunisia)	גבס (תוניסיה)	10
Qafṣah (Tunisia)	גאפסה (תוניסיה)	2
Qayrawān (Tunisia)	קירואן (תוניסיה)	2
Queens (New York, N.Y.)	קווינס (ניו יורק, ניו יורק)	3
Quito (Ecuador)	קיטו (אקוודור)	1
Ra'ananna (Israel)	רעננה (ישראל)	10
Rabka (Nowy Sącz, Poland)	ראבקה (צנז, פולין)	1
Radashkovichy (Belarus)	רדושקוביצה (בלארוס)	1
Radebeul (Germany)	רדהבויל (גרמניה)	1
Radekhiv (Ukraine)	רדיחוב (אוקראינה)	1
Radom (Województwo Mazowieckie, Poland)	ראדום (מדינת מזובייצק, פולין)	7
Radomsko (Poland)	רדומסק (פולין)	4
Radunʹ (Belarus)	רדין (בלארוס)	1
Radziłów (Poland)	ראדזילוב (פולין)	1
Radzymin (Poland)	רדזימין (פולין)	1
Rafaḥ (Gaza Strip)	רפיח (רצועת עזה)	2
Rajgród (Poland)	רייגרוד (פולין)	2
Ramat Aviv (Tel Aviv-Yafo, Israel)	רמת אביב (תל אביב-יפו, ישראל)	1
Ramat David (Israel)	רמת דוד (ישראל)	1
Ramat Ef'al (Ramat Gan, Israel)	רמת אפעל (רמת גן, ישראל)	1
Ramat Gan (Israel)	רמת גן (ישראל)	43
Ramat Hakovesh (Israel)	רמת הכובש (ישראל)	4
Ramat Hasharon (Israel)	רמת השרון (ישראל)	3
Ramat Hen (Ramat Gan, Israel)	רמת חן (רמת גן, ישראל)	1
Ramat Rahel (Israel)	רמת רחל (ישראל)	1
Ramat Yohanan (Israel)	רמת יוחנן (ישראל)	7
Ramatayim (Hod Hasharon, Israel)	רמתיים (הוד השרון, ישראל)	1
Ramla (Israel)	רמלה (ישראל)	1
Ramsgate (England)	רמסגייט (אנגליה)	7
Raseiniai (Lithuania)	ראסייני (ליטא)	2
Rastatt (Germany)	ראסטט (גרמניה)	1
Rava-Rusʹka (Ukraine)	ראווה רוסקה (אוקראינה)	3
Ravenna (Italy)	רוונה (איטליה)	1
Reading (Pa.)	רידינג (פנסילבניה)	1
Recanati (Italy)	רקנאטי (איטליה)	1
Red Sea	ים סוף	1
Regensburg (Germany)	רגנסבורג (גרמניה)	4
Reggio Emilia (Italy)	רג'יו (איטליה)	7
Rehovot (Israel)	רחובות (ישראל)	32
Rhinebeck (N.Y.)	ריינבק (ניו יורק)	1
Rhode Island	רוד אילנד	1
Rhodes (Greece)	רודוס (יוון)	7
Rhodesia and Nyasaland	רודזיה וניאסלנד	1
Richmond (England)	ריצ'מונד (אנגליה)	1
Richmond (Va.)	ריצ'מונד (וירג'יניה)	1
Richmond upon Thames (London, England)	ריצ'מונד שעל התמזה (לונדון, אנגליה)	1
Rietavas (Lithuania)	ריטובה (ליטא)	1
Rieti (Italy)	רייטי (איטליה)	1
Rio de Janeiro (Brazil : State)	ריו דה ז'ניירו (ברזיל : מדינה)	1
Rio de Janeiro (Brazil)	ריו דה ז'ניירו (ברזיל)	10
Rishon Letsiyon (Israel)	ראשון לציון (ישראל)	27
Rochester (Minn.)	רוצ'סטר (מינסוטה)	1
Rochester (N.Y.)	רוצ'סטר (ניו יורק)	2
Rockville (Md.)	רוקוויל (מרילנד)	1
Rödelheim (Germany)	רדלהיים (גרמניה)	1
Rohatyn (Ukraine)	רוהטין (אוקראינה)	4
Roman (Romania)	רומאן (רומניה)	1
Romania	רומניה	1
Rome (Italy)	רומא (איטליה)	45
Rome	רומי	15
Romny (Ukraine)	רומני (אוקראינה)	1
Ropczyce (Poland)	רופשיץ (פולין)	2
Roquebrune-Cap-Martin (France)	רוקואברון-קאפ-מרטין (צרפת)	1
Rosh Ha'ayin (Israel)	ראש העין (ישראל)	1
Rosh Pina (Israel)	ראש פינה (ישראל)	3
Rostock (Germany)	רושטוק (גרמניה)	1
Rostov (Russia)	רוסטוב (רוסיה)	3
Rostov-na-Donu (Russia)	רוסטוב על הדון	1
Rotterdam (Netherlands)	רוטרדם (הולנד)	3
Rouen (France)	רואן (צרפת)	2
Roxbury (Boston, Mass.)	רוקסברי (בוסטון, מסצ'וסטס)	1
Rozdil (Ukraine)	רוזדיל (אוקראינה)	1
Roz︠h︡ni︠a︡tiv (Ukraine)	רוז'ניטייב (אוקראינה)	3
Rozwadów (Poland)	רוזודוב (פולין)	1
Rudky (Lʹvivsʹka oblastʹ, Ukraine)	רודקי (מחוז לביב, אוקראינה)	1
Rymanów (Poland)	רימנוב (פולין)	4
Rypin (Poland)	ריפין (פולין)	1
Rzeszów (Poland)	רישא (פולין)	15
Sabbioneta (Italy)	סביונטה (איטליה)	1
Sadhora (Chernivtsi, Ukraine)	סדיגורה (צ'רנוביץ, אוקראינה)	1
Šafov (Czech Republic)	שאפא (צ'כיה)	1
Saïda (Algeria : Province)	סעידה (אלג'יריה : מחוז)	2
Saint Louis (Mo.)	סנט לואיס (מיזורי)	4
Saint Petersburg (Russia)	פטרבורג (רוסיה)	62
Saint-Tropez (France)	סן טרופה (צרפת)	1
Šakiai (Lithuania)	שקי (ליטא)	1
Salgótarján (Hungary)	שלגוטרין (הונגריה)	1
Salt Lake City (Utah)	סולט לייק סיטי (יוטה)	1
Salzburg (Austria)	זלצבורג (אוסטריה)	1
Sambir (Sambirsʹkyĭ raĭon, Ukraine)	סמבור (אוקראינה)	6
Samoa	סמואה	1
San Antonio (Tex.)	סן אנטוניו (טקסס)	1
San Diego (Calif.)	סן דייגו (קליפורניה)	3
San Francisco (Calif.)	סן פרנסיסקו (קליפורניה)	12
San Juan (P.R.)	סן חואן (פוארטו ריקו)	1
San Lorenzo del Escorial (Spain)	המנזר המלכותי של סן לורנצו (ספרד)	1
San Luis Obispo (Calif.)	סן לואיס אוביספו (קליפורניה)	1
San Miguel de Allende (Mexico)	סן מיגל דה איינדה (מקסיקו)	1
San Remo (Italy)	סן רמו (איטליה)	3
San'a (Yemen)	צנעא (תימן)	10
Sandomierz (Poland)	סנדומיז' (פולין)	4
Sandringham (England)	סנדרינגהם (אנגליה)	2
Sankt Goar (Germany)	סנקט גואר (גרמניה)	1
Sannicandro Garganico (Italy)	סניקנדרו גרגניקו (איטליה)	1
Sanok (Poland)	סנוק (פולין)	4
Sansepolcro (Italy)	סנספולקרו (איטליה)	1
Santa Ana (Calif.)	סנטה אנה (קליפורניה)	1
Santa Barbara (Calif.)	סנטה ברברה (קליפורניה)	5
Santa Fe (N.M.)	סנטה פה (ניו מקסיקו)	1
Santa Monica (Calif.)	סנטה מוניקה (קליפורניה)	9
Santa Rosa (Calif.)	סנטה רוזה (קליפורניה)	1
Sarasota (Fla.)	סרסוטה (פלורידה)	1
Saratov (Russia)	סרטוב (רוסיה)	3
Sarid (Israel)	שריד (ישראל)	5
Sárospatak (Hungary)	שרושפטק (הונגריה)	1
Sárvár (Hungary)	סארבר (הונגריה)	1
Sasiv (Ukraine)	ססוב (אוקראינה)	1
Sataniv (Ukraine)	סאטאניב (אוקראינה)	3
Sátoraljaújhely (Hungary)	אוהל (הונגריה)	6
Scandiano (Italy)	סקנדיאנו (איטליה)	1
Scarsdale (N.Y.)	סקרסדייל (ניו יורק)	1
Sceaux (Hauts-de-Seine, France)	סו (הוטס-דה-סן, צרפת)	1
Scheveningen (Netherlands)	סכוונינגן (הולנד)	1
Scottsdale (Ariz.)	סקוטסדייל (אריזונה)	1
Seattle (Wash.)	סיאטל (ושינגטון)	2
Sečovce (Slovakia)	סצ'ובצה (סלובקיה)	1
Sedan (France)	סדאן (צרפת)	1
Sede Boker (Israel)	שדה בוקר (ישראל)	1
Sede Eliyahu (Israel)	שדה אליהו (ישראל)	2
Sede Nahum (Israel)	שדה נחום (ישראל)	6
Sede Ya'akov (Israel)	שדה יעקב (ישראל)	1
Šeduva (Lithuania)	שדובה (ליטא)	2
Sędziszów (Poland)	סאנדזישוב (פולין)	3
Sefrou (Morocco)	צפרו (מרוקו)	7
Segovia (Spain)	סגוביה (ספרד)	1
Seini (Romania)	סיניע (רומניה)	1
Seirijai (Lithuania)	סרהיי (ליטא)	1
Sejny (Poland)	סיני (פולין)	1
Selsey (West Sussex, England)	סלסי (מערב סאסקס, אנגליה)	1
Senica (Slovakia)	סניצה (סלובקיה)	1
Senta (Serbia)	זנטה (סרביה)	1
Seoul (Korea)	סיאול (קוריאה)	4
Serbia	סרביה	1
Serock (Warsaw, Poland)	סרוצק (ורשה, פולין)	1
Sevastopolʹ (Ukraine)	סבסטופול (אוקראינה)	1
Seville (Spain)	סויליה (ספרד)	1
Sèvres (France)	סוור (צרפת)	1
Sha'alvim (Israel)	שעלבים (ישראל)	1
Sha'ar Ha'amakim (Israel)	שער העמקים (ישראל)	2
Shchuchyn (Belarus)	שצ'וצ'ין (בלארוס)	1
Sheluhot (Israel)	שלוחות (ישראל)	1
Shereshevo (Belarus)	שערשעוו (בלארוס)	1
Shīrāz (Iran)	שיראז (איראן)	1
Shivta (Extinct city) (Israel)	שבטה (עיר קדומה) (ישראל)	1
Shkloŭ (Belarus)	שקלוב (בלארוס)	4
Shoham (Israel)	שוהם (ישראל)	1
Šiauliai (Lithuania)	שול (ליטא)	11
Sibiu (Romania)	סיביו (רומניה)	1
Siedlce (Poland)	שדלץ (פולין)	11
Siena (Italy)	סיינה (איטליה)	2
Sieniawa (Przemyśl, Poland)	שיניוה (פשמישל, פולין)	4
Sierpc (Poland : Powiat)	שרפץ (פולין : מחוז)	1
Sighet (Romania)	סיגט (רומניה)	8
Sighetu Marmației (Romania)	סיגטו מרמציי (רומניה)	4
Sighișoara (Romania)	סיגישוארה (רומניה)	1
Sils im Engadin (Switzerland)	סילס אם אנגדין (שווייץ)	1
Silver Spring (Md.)	סילבר ספרינג (מרילנד)	1
Simferopol (Ukraine)	סימפרופול (אוקראינה)	2
Simleul-Silvaniei (Romania)	שימלאו סילבאניי (רומניה)	2
Singapore	סינגפור	1
Siponto (Italy)	סיפונטו (איטליה)	1
Siret (Romania)	סירט (רומניה)	1
Skopje (Macedonia)	סקופיה (מקדוניה)	2
Slavkov u Brna (Czech Republic)	סלאוקוב או ברנא (צ'כיה)	1
Slonim (Belarus)	סלונים (בלארוס)	14
Slovakia	סלובקיה	1
Slutsk (Belarus)	סלוצק (בלארוס)	6
Smila (Cherkasʹka oblastʹ, Ukraine)	סמילה (מחוז צ'רקסקה, אוקראינה)	2
Smolensk (Russia)	סמולנסק (רוסיה)	1
Smorgon (Belarus)	סמרגון (בלארוס)	2
Sni︠a︡tyn (Ukraine)	שניאטין (אוקראינה)	2
Sochaczew (Poland)	סוכטשוב (פולין)	1
Sofia (Bulgaria)	סופיה (בולגריה)	8
Soho (London, England)	סוהו (לונדון, אנגליה)	1
Sokalʹ (Ukraine)	סוקאל (אוקראינה)	2
Sokołów Podlaski (Poland)	סוקולוב פודלסקי (פולין)	1
Sokyri︠a︡ny (Ukraine)	סקורן (אוקראינה)	1
Soroca (Moldova)	סורוקה (מולדובה)	1
Sosnowiec (Wojewodztwo Slaskie, Poland)	סוסנוביץ (שלזיה, פולין)	2
South Africa	דרום אפריקה	1
South Brunswick (N.J. : Township)	סאות ברונסויק (ניו ג'רזי)	1
Southampton (England)	סאות'המפטון (אנגליה)	1
Southport (England)	סאותפורט (אנגליה)	1
Soviet Union	ברית המועצות	44
Spain	ספרד	8
Speyer (Germany)	שפייר (גרמניה)	1
Split (Croatia)	ספליט (קרואטיה)	1
Stabiae (Extinct city)	סטביה (עיר קדומה)	1
Stamford (Conn.)	סטמפורד (קונטיקט)	1
Stanford (Calif.)	סטנפורד (קליפורניה)	1
Stanislav (Ukraine)	סטניסלב (אוקראינה)	9
Starai︠a︡ Russa (Russia)	סטאראיה רוסה (רוסיה)	1
Starodub (Russia)	סטארודוב (רוסיה)	1
Starokosti︠a︡ntyniv (Ukraine)	סטארוקוסטיאנטיניב (אוקראינה)	1
Staryĭ Sambir (Ukraine)	סטארי סמביר (אוקראינה)	3
Stawiski (Poland)	סטויסק (פולין)	3
Steglitz (Berlin, Germany)	שטיגליץ (ברלין, גרמניה)	1
Stettin (Germany)	שטטין (גרמניה)	1
Stockholm (Sweden)	סטוקהולם (שבדיה)	18
Stolin (Belarus)	סטולין (בלארוס)	1
Strakonice (Czech Republic)	סטרקוניצ'ה (צ'כיה)	1
Strasbourg (France)	שטרסבורג (צרפת)	2
Stratford-upon-Avon (England)	סטרטפורד על נהר אייבון (אנגליה)	2
Stratyn (Ukraine)	סטראטין (אוקראינה)	1
Stryĭ (Ukraine)	סטריי (אוקראינה)	12
Strzyżów (Rzeszów, Poland)	סטז'יז'וב (פולין)	2
Stupava (Slovakia)	שטומפה (סלובקיה)	1
Stuttgart (Germany)	שטוטגרט (גרמניה)	4
Subotica (Subotica, Serbia)	סובוטיקה (סובוטיקה, סרביה)	1
Suceava (Romania)	שוץ (רומניה)	1
Sudova Vyshni︠a︡ (Ukraine)	סונדובה וישניא (אוקראינה)	1
Sulzburg (Germany)	זולצבורג (גרמניה)	1
Šurany (Slovakia)	סורני (סלובקיה)	2
Suwałki (Poland)	סובלקי (פולין)	8
Svaliava (Ukraine)	סבליאבה (אוקראינה)	2
Švenčionys (Lithuania)	שוינצין (ליטא)	1
Svir (Belarus)	סויר (בלארוס)	1
Svislach (Hrodzenskaia voblasts, Belarus)	סוויסלוץ' (מחוז הורדנה, בלארוס)	1
Swampscott (Mass.)	סוומפסקוט (מסצ'וסטס)	1
Switzerland	שווייץ	4
Sydney (N.S.)	סידני (נובה סקוטיה)	1
Sydney (N.S.W.)	סידני (אוסטרליה)	5
Syracuse (Italy)	סירקיוז (איטליה)	1
Syzranʹ (Russia)	סיזרן (רוסיה)	1
Szczebrzeszyn (Poland)	שצ'בז'שין (פולין)	3
Szczekociny (Poland)	שצ'קוצ'ין (פולין)	1
Szecseny (Hungary)	סצ'ני (הונגריה)	2
Szeged (Hungary)	סגד (הונגריה)	1
Szeghalom (Hungary)	סגהלום (הונגריה)	1
Székesfehérvár (Hungary)	סקשפהרור (הונגריה)	1
Szerencs (Hungary)	סרנץ' (הונגריה)	2
Szikszó (Hungary)	סיקסו (הונגריה)	1
Szombathely (Hungary)	סומבטהי (הונגריה)	1
Szydłów (Województwo Świętokrzyskie, Poland)	שידלוב (פולין)	1
Szydłowiec (Województwo Mazowieckie, Poland)	שידלוביץ (מדינת מזובייצק, פולין)	1
Tab (Hungary)	טאב (הונגריה)	3
Tabrīz (Iran)	תבריז (איראן)	1
Taipei (Taiwan)	טייפה (טאיוואן)	1
Tal'ne (Ukraine)	טלנה (אוקראינה)	1
Talavera de la Reina (Spain)	טלוורה דה לה ריינה (ספרד)	1
Tallinn (Estonia)	טאלין (אסטוניה)	1
Tállya (Hungary)	טאליה (הונגריה)	1
Tampa (Fla.)	טמפה (פלורידה)	1
Tangier (Morocco)	טנג'יר (מרוקו)	2
Tarashcha (Ukraine)	טרשצ'ה (אוקראינה)	1
Tarnobrzeg (Poland)	טרנובז'ג (פולין)	4
Tashkent (Uzbekistan)	טשקנט (אוזבקיסטן)	1
Tasnad (Romania)	טשנד (רומניה)	1
Tass (Hungary)	טאש (הונגריה)	1
Tehran (Iran)	טהרן (איראן)	1
Tel Adashim (Israel)	תל עדשים (ישראל)	1
Tel Aviv-Yafo (Israel)	תל אביב-יפו (ישראל)	970
Tel Hai (Israel)	תל חי (ישראל)	2
Tel Hashomer (Ramat Gan, Israel)	תל השומר (רמת גן, ישראל)	3
Tel Katsir (Israel)	תל קציר (ישראל)	2
Tel Mond (Israel)	תל מונד (ישראל)	2
Tel-Yosef (Israel)	תל יוסף (ישראל)	6
Telenești (Moldova : Raionul)	טלנשטי (מולדובה : מחוז)	1
Telouet (Morocco)	תילונת (מרוקו)	1
Telšiai (Lithuania)	טלז (ליטא)	7
Teplice (Czech Republic)	טפליצה (צ'כיה)	1
Terebovli︠a︡ (Ukraine)	טרמבובלה (אוקראינה)	1
Terezín (Ústecký kraj, Czech Republic)	טרזין (מחוז אוסטי נד לבם, צ'כיה)	1
Ternopilʹ (Ukraine)	טרנופול (אוקראינה)	17
Teruel (Spain)	טרואל (ספרד)	1
Thessalonikē (Greece)	סלוניקי (יוון)	97
Tiberias (Israel)	טבריה (ישראל)	60
Tileagd (Romania)	טעלעגד (רומניה)	1
Tilsit (Germany)	טילזיט (גרמניה)	1
Timisoara (Romania)	טימישוארה (רומניה)	5
Tirat Tsvi (Israel)	טירת צבי (ישראל)	2
Tire (Turkey)	טירה (טורקיה)	1
Tirgu-Mures (Romania)	מרושושרהלי (רומניה)	2
Tiszafüred (Hungary)	טיסאפורד (הונגריה)	3
Tiszaigar (Hungary)	טיסא-איגאר (הונגריה)	1
Tiszavasvári (Hungary)	טיסושוארי (הונגריה)	2
Tlemcen (Algeria)	תלמסן (אלג'יריה)	3
Todi (Italy)	טודי (איטליה)	1
Tokaj (Hungary)	טוקאי (הונגריה)	5
Tokyo (Japan)	טוקיו (יפן)	3
Tolcsva (Hungary)	טולצ׳בה(הונגריה)	1
Toledo (Ohio)	טולדו (אוהיו)	1
Toledo (Spain)	טולדו (ספרד)	6
Tolna (Hungary)	טולנה (הונגריה)	3
Tomaszów Lubelski (Poland)	טומשוב לובלסקי (פולין)	1
Tomsk (Russia)	טומסק (רוסיה)	1
Topol̕čany (Slovakia)	טופולצ'ני (סלובקיה)	2
Toronto (Ont.)	טורונטו (אונטריו)	32
Toruń (Poland)	טורן (פולין)	1
Tours (France)	טור (צרפת)	1
Trakai (Lithuania)	טראקאי (ליטא)	1
Trawniki (Lublin, Poland)	טרווניקי (לובלין, פולין)	1
Třebíč (Czech Republic)	טרביץ' (צ'כיה)	1
Treblinka (Poland)	טרבלינקה (פולין)	14
Trenčín (Západoslovenský kraj, Slovakia)	טרנצ'ין (סלובקיה)	3
Třešt̕ (Czech Republic)	טרסט (צ'כיה)	1
Treviso (Italy)	טרוויזו (איטליה)	1
Trieste (Italy)	טריסטה (איטליה)	15
Trinidad	טרינידד	1
Tripoli (Libya)	טריפולי (לוב)	15
Troyes (France)	טרויש (צרפת)	1
Trzcianka (Piła, Poland)	שנלנק (פולין)	1
Trzcianne (Poland)	טרעסטיני (פולין)	1
Trzebinia (Kraków, Poland)	טשבין (קרקוב, פולין)	1
Tse'elim (Israel)	צאלים (ישראל)	1
Tsefat (Israel)	צפת (ישראל)	77
Tsofit (Israel)	צופית (ישראל)	1
Tsur Moshe (Israel)	צור משה (ישראל)	1
Tübingen (Germany)	טיבינגן (גרמניה)	3
Tucson (Ariz.)	טוסון (אריזונה)	3
Tulsa (Okla.)	טולסה (אוקלהומה)	2
Tunbridge Wells (England)	טונברידג' וולס (אנגליה)	1
Tunis (Tunisia)	תוניס (תוניסיה)	48
Tunisia	תוניסיה	1
Turets (Belarus)	טורעץ (בלארוס)	1
Turin (Italy)	טורינו (איטליה)	7
Turka (Lʹvivsʹka oblastʹ, Ukraine)	טורקא (אוקראינה)	4
Turkey	טורקיה	2
Tuskegee (Ala.)	טוסקגי (אלבמה)	1
Twickenham (London, England)	טוויקנהאם (לונדון, אנגליה)	1
Tyczyn (Rzeszów, Poland)	טיצ'ין (רישא, פולין)	2
Tykocin (Poland)	טיקוצין (פולין)	3
Tyre (Lebanon)	צור (לבנון)	1
Tysmenyt︠s︡i︠a︡ (Ukraine)	טיסמניץ (אוקראינה)	4
Uccle (Belgium)	אוקל (בלגיה)	2
Udim (Israel)	אודים (ישראל)	2
Uherský Brod (Czech Republic)	אורסקי ברוד (צ'כיה)	3
Újfehértó (Hungary)	רצפרטה (הונגריה)	1
Ukmerge (Lithuania)	אוקמרגה (ליטא)	5
Ukraine	אוקראינה	2
Ulashkivtsi (Ukraine)	אולאשקובצה (אוקראינה)	1
Ulm (Germany)	אולם (גרמניה)	1
Umanʹ (Ukraine)	אומן (אוקראינה)	3
United States	ארצות הברית	27
Unkel/Rhein (Germany)	אונקל/ריין (גרמניה)	1
Urfa (Turkey)	אורפה (טורקיה)	1
Úsov (Czech Republic)	אוסזי (צ'כיה)	1
Ustrzyki Dolne (Poland)	איסטריק (פולין)	1
Ustyluh (Ukraine)	אוסטילה (אוקראינה)	1
Uzès (France)	אוזס צרפת	1
Uz︠h︡horod (Ukraine)	אונגור (אוקראינה)	6
Vác (Hungary)	ויצן (הונגריה)	6
Valencia (Spain)	ולנסיה (ספרד)	2
Valladolid (Spain)	ואיאדוליד (ספרד)	1
Valozhyn (Belarus)	וולוז'ין (בלארוס)	2
Varna (Bulgaria)	ורנה (בולגריה)	1
Várpalota (Hungary)	ורפלוטה (הונגריה)	1
Vasilishki (Belarus)	וסילישקי (בלארוס)	1
Vaŭkavysk (Belarus)	וולקוביסק (בלארוס)	3
Vauvert (France)	וואוברט (צרפת)	1
Velha Goa (India)	גואה העתיקה (הודו)	1
Vence (France)	ואנס (צרפת)	1
Venice (Italy)	ונציה (איטליה)	35
Vermont	ורמונט	1
Verona (Italy)	ורונה (איטליה)	4
Verpelét (Hungary)	ווערפעלעט (הונגריה)	1
Versailles (France)	ורסיי (צרפת)	3
Verson (France)	ורסון (צרפת)	1
Veszprém (Hungary)	וספרם (הונגריה)	1
Vevey (Switzerland)	ווה (שווייץ)	4
Vézelay (France)	ווזלה (צרפת)	1
Vidzy (Belarus)	וידז (בלארוס)	1
Viekšniai (Lithuania)	ווקסנא (ליטא)	1
Vienna (Austria)	וינה (אוסטריה)	157
Vileĭka (Minskai︠a︡ voblastsʹ, Belarus)	ווילייקה (מחוז מינסק, בלארוס)	2
Vilkaviškis (Lithuania)	וילקובישק (ליטא)	1
Villemomble (France)	וילמומבל (צרפת)	1
Vilnius (Lithuania)	וילנה (ליטא)	150
Vinnyt︠s︡ʹka oblastʹ (Ukraine)	מחוז ויניצה (אוקראינה)	1
Vinnyt︠s︡i︠a︡ (Ukraine)	ויניצה (אוקראינה)	1
Virbalis (Lithuania)	וירבלן (ליטא)	1
Vișeu de Sus (Romania)	וישאו דה סוס (רומניה)	4
Visp (Switzerland)	וויספ (שווייץ)	1
Vištytis (Lithuania)	ווישטינץ (ליטא)	1
Vitsebskai︠a︡ voblastsʹ (Belarus)	מחוז ויטבסק (בלארוס)	7
Vladivostok (Russia)	ולדיווסטוק (רוסיה)	1
Vlčany (Slovakia)	פורקושד (סלובקיה)	1
Vojvodina (Serbia)	וויבודינה (סרביה)	1
Volhynia (Ukraine)	ווהלין (אוקראינה)	1
Vrbové (Slovakia)	ורבובה (סלובקיה)	1
Všeruby (Domažlice, Czech Republic)	ושרובי (צ'כיה)	1
Vuzlove (Zakarpatsʹka oblastʹ, Ukraine)	ווזלובה (מחוז זקרפטיה, אוקראינה)	1
Vynohradiv (Ukraine)	וינוגרדוב (אוקראינה)	3
Vyz︠h︡nyt︠s︡i︠a︡ (Ukraine)	ויז'ניץ (אוקראינה)	3
Wallingford (England)	וולינגפורד (אנגליה)	1
Walsdorf (Idstein, Germany)	וולסדורף (אידשטיין, גרמניה)	1
Waltham (Mass.)	וולתם (מסצ'וסטס)	1
Wandsbek (Germany)	ונדזבק (גרמניה)	2
Wanfried (Germany)	ונפרידן (גרמניה)	1
Wannsee (Berlin, Germany)	ואנזה (ברלין, גרמניה)	1
Warm Springs (Ga.)	ווארם ספרינגס (ג'ורג'יה)	1
Warsaw (Poland)	ורשה (פולין)	241
Warta (Poland)	וארטה (פולין)	1
Washington (D.C.)	ושינגטון (די. סי.)	4
Wasilków (Poland)	וסילקוב (פולין)	1
Watford (England)	ווטפורד (אנגליה)	1
Węgrów (Poland)	ונגרוב (פולין)	6
Wellington (N.Z.)	ולינגטון (ניו זילנד)	1
Wels (Austria)	וולס (אוסטריה)	1
West Hollywood (Calif.)	מערב הוליווד (קליפורניה)	1
West Palm Beach (Fla.)	מערב פאלם ביץ' (פלורידה)	1
Westminster (London, England)	ווסטמינסטר (לונדון, אנגליה)	1
Widawa (Poland)	וידווה (פולין)	1
Wieliczka (Poland)	ויליצ'קה (פולין)	2
Wieluń (Łódź, Poland)	ויילון (מחוז לודז, פולין)	1
Wiesbaden (Germany)	וויסבאדן (גרמניה)	2
Wilkes-Barre (Pa.)	ווילקס-באר (פנסילבניה)	1
Williamsburg (New York, N.Y.)	וילימסבורג (ניו יורק, נ.י. : שכונה)	1
Winnipeg (Man.)	וויניפג (מניטובה)	6
Wisconsin	ויסקונסין	3
Wiskitki (Poland)	ויסקיט (פולין)	2
Włocławek (Poland)	ולוצלאווק (פולין)	2
Wodzisław (Poland)	וודז'יסלאב (פולין)	2
Wolbórz (Poland)	וולברז (פולין)	1
Wolfenbüttel (Germany)	וולפנביטל (גרמניה)	1
Worms (Germany)	וורמס (גרמניה)	12
Wrocław (Poland)	ורוצלב (פולין)	40
Września (Województwo Wielkopolskie, Poland)	וז'אסנייה (פולין)	1
Wuppertal (Germany)	וופרטל (גרמניה)	1
Württemberg (Germany)	ווירטמברג	1
Würzburg (Germany)	וירצבורג (גרמניה)	6
Wysokie Mazowieckie (Poland)	ויסוקה מזוביצק (פולין)	1
Wyszogród (Poland)	וישוגרוד (פולין)	3
Yad Hanna (Israel)	יד חנה (ישראל)	1
Yad Mordekhai (Israel)	יד מרדכי (ישראל)	1
Yagur (Israel)	יגור (קבוץ)	6
Yas'ur (Galilee) (Israel)	יסעור (גליל) (ישראל)	1
Yavne (Israel)	יבנה (ישראל)	2
Yavne'el (Israel)	יבנאל (ישראל)	5
Yehud (Israel)	יהוד (ישראל)	3
Yemen (Republic)	תימן (רפובליקה)	2
Yifat (Israel)	יפעת (ישראל)	4
Yonkers (N.Y.)	יונקרס (ניו יורק)	1
Zabłudów (Poland)	זבלודוב (פולין)	1
Żabno (Województwo Małopolskie, Poland)	ז'אבנו (פולין)	1
Zabolotiv (Ukraine)	זבלוטוב (אוקראינה)	4
Zagreb (Croatia)	זגרב (קרואטיה)	2
Zakopane (Poland)	זקופנה (פולין)	2
Zakroczym (Poland)	זאקרוצ'ים (פולין)	1
Zakynthos (Greece)	זקינתוס (יוון)	1
Zaleshchiki (Ukraine)	זלישצ'יק (אוקראינה)	5
Zaliztsi (Ukraine)	זלוזיץ (אוקראינה)	2
Zambrów (Poland)	זאמברוב	1
Zamość (Poland)	זמושץ' (פולין)	12
Zandvoort (Netherlands)	זנדפורט (הולנד)	1
Zaragoza (Spain)	סרגוסה (ספרד)	4
Zarasai (Lithuania)	זרסי (ליטא)	1
Zaręby Kościelne (Poland)	זארבי קושצ'לנה (פולין)	1
Żarki (Poland)	ז'רקי (פולין)	1
Zarzis (Tunisia)	זרזיס (תוניסיה)	1
Zaslavlʹ (Belarus)	זסלבל (בלארוס)	1
Zawalów (Poland)	זאוואלוב (פולין)	1
Zboriv (Ukraine)	זבורוב (אוקראינה)	2
Zėlʹva (Belarus)	זלוה (בלארוס)	1
Zerbst (Germany)	צרבסט (גרמניה)	1
Zgierz (Poland)	זגירז' (פולין)	2
Zhytomyr (Ukraine)	זיטומיר (אוקראינה)	3
Zikhron Ya'akov (Israel)	זכרון יעקב (ישראל)	3
Zimbabwe	זימבבואה	1
Żółkiew (Poland)	ז'ולקייב (פולין)	18
Zolochiv (Lʹvivsʹka oblastʹ, Ukraine)	זולוצ'יב (מחוז לביב, אוקראינה)	8
Żory (Poland)	צורי (פולין)	1
Zsámbék (Hungary)	זסמבק (הונגריה)	1
Zurich (Switzerland)	ציריך (שווייץ)	30
Zwoleń (Radom, Poland)	זוואלין (ראדום, פולין)	1
Zwolle (Netherlands)	זוולה (הולנד)	2
